	celltype
AACCTTAAGTAGCGGG-1	RG, Astro, OPC
AACAGCAAGTTATCCT-1	Subplate
AACTAGCTCAATGTGC-1	IPC
AAAGGCTCACCTGGTG-1	Ependymal cells
AACTAGCTCAGCACGC-1	RG, Astro, OPC
AACAGCAAGTTAGTGC-1	Upper Layer
AAACCGGCAACTAACT-1	Upper Layer
AAACGTACATGTGGGA-1	Upper Layer
AAAGCACCAGGAATCG-1	Interneurons2
AAACCAACAACTGGGA-1	RG, Astro, OPC
AACTAGCTCGCGACAC-1	Upper Layer
AAACGTACAAGCGAGC-1	Upper Layer
AAAGCAAGTTGCTGGG-1	Subplate
AAAGGCTCAAGGTACG-1	Upper Layer
AACCTCCTCAGGTCCA-1	V-SVZ
AAAGGCTCAAATATCC-1	Ependymal cells
AACGACAAGCATGTTA-1	Deeper Layer
AAAGCCCGTGATCAGC-1	Interneurons2
AAAGGTTAGTTTGAGC-1	Upper Layer
AAATGCCTCATAATCG-1	Subplate
AAAGGCTCAATATACC-1	V-SVZ
AAAGCACCATCTAGCA-1	Ependymal cells
AAAGGCTCATAGCGGA-1	RG, Astro, OPC
AACATTGTCGATTCTT-1	RG, Astro, OPC
AAAGCCGCACAACCTA-1	Upper Layer
AACGGTAAGGGCTTTG-1	Interneurons3
AACATAGCAACCCTAA-1	RG, Astro, OPC
AACGACAAGTAAGTCC-1	IPC
AAACATGCACTTACAG-1	Upper Layer
AAACCGGCACTTCATC-1	Interneurons2
AAACAGCCATATTGAC-1	Deeper Layer
AACAGCAAGGTTTGCG-1	Cajal-Retzius
AAACAGCCATGGTTAT-1	Subplate
AACGACAAGTCACGAT-1	Upper Layer
AACCGCTCAATCCCTT-1	Upper Layer
AACAGGATCGATTTAG-1	Upper Layer
AACCGCTCAATAATCC-1	Deeper Layer
AAAGGTTAGCTTACTT-1	Upper Layer
AAAGGAGCAATTTAGC-1	Upper Layer
AAAGCTTGTCATGCCC-1	RG, Astro, OPC
AACTACTCAAACGGGC-1	V-SVZ
AACGCCCAGGACAATG-1	IPC
AAACGCGCATCACTTC-1	Upper Layer
AACCTCACAGGTTCAC-1	Upper Layer
AACCTTAAGTAACAGG-1	Upper Layer
AAAGCACCAACTGGCT-1	RG, Astro, OPC
AAAGGTTAGTTGCGTG-1	Upper Layer
AAAGCCCGTTCACCAT-1	RG, Astro, OPC
AAACCGCGTCACCAAA-1	RG, Astro, OPC
AAACGTACAAGGCCAA-1	V-SVZ
AACCCGCAGGGCTAAA-1	Interneurons2
AACGCCCAGCACTAGT-1	IPC
AACTAGCTCGTTTCTG-1	V-SVZ
AACCTCCTCGGGCCAT-1	V-SVZ
AAACCAACATCGTTCT-1	Interneurons2
AACATAGCATAAACCT-1	Deeper Layer
AACCTTAAGGGCTAAA-1	Subplate
AACAGATAGAGGAGTC-1	RG, Astro, OPC
AAACAGCCATCAGCAC-1	Cajal-Retzius
AAACAGCCAACCGCCA-1	Upper Layer
AAAGCCGCAGGCAAGC-1	RG, Astro, OPC
AACTACTCAGCCTGCA-1	Deeper Layer
AACATAGCACCTGGTG-1	Deeper Layer
AACATTGTCCCGCATT-1	Deeper Layer
AACAGCAAGTAAAGGT-1	Interneurons2
AAAGCCCGTATGGTGC-1	IPC
AAACGCGCAGTTATCG-1	RG, Astro, OPC
AAAGCAAGTTTGGGCG-1	Interneurons1
AAACAGCCAAGGTCGA-1	RG, Astro, OPC
AACATTGTCACCTGTC-1	Upper Layer
AAACAGCCAGGAACAT-1	Deeper Layer
AACGCTAGTCAGGCCA-1	Upper Layer
AAACGCGCAGCTAATT-1	Deeper Layer
AAAGCAAGTACCGGAT-1	V-SVZ
AACCTCCTCTCGCCCA-1	IPC
AAAGGCTCATTGGGAG-1	RG, Astro, OPC
AACCCGCAGGCCAATT-1	RG, Astro, OPC
AAAGCACCACTGACTA-1	Interneurons2
AACAGGATCAATGTGC-1	IPC
AAAGCAAGTGAGGTAG-1	RG, Astro, OPC
AAACCGAAGCTACTGG-1	Interneurons1
AAAGGAGCATTTAAGC-1	Interneurons1
AAATGCCTCGATTCTT-1	RG, Astro, OPC
AACTACTCAGCTCATA-1	V-SVZ
AAACCGGCAATTAGGA-1	Deeper Layer
AACATTGTCCTTCTAG-1	RG, Astro, OPC
AAAGCCGCATCCGTAA-1	Deeper Layer
AACAGATAGTCCTGAG-1	Interneurons1
AAAGGCTCAATCCCTT-1	Subplate
AACCGCTCACCTAAGC-1	V-SVZ
AAACGTACATCCTGAA-1	Subplate
AAAGCAAGTCACAGCG-1	Interneurons2
AAACCGCGTGCAATGC-1	Upper Layer
AACCTTGCAGCGCTTG-1	Upper Layer
AAGGTGCAGGAGGTTA-1	Upper Layer
AAGCGGGTCCCATAGG-1	V-SVZ
AAGCCTGTCATGGTTA-1	Ependymal cells
AAGGTATAGCATTAGC-1	RG, Astro, OPC
AAGTGTTGTATTGGTG-1	V-SVZ
AAGCTTGGTGTTTGTC-1	Ependymal cells
AAGCCACGTTTGTGGA-1	RG, Astro, OPC
AAGTAGCCACTTCATC-1	Interneurons1
AAGCTATGTGTCCTGC-1	Upper Layer
AAGACATAGGCATGTT-1	Deeper Layer
AAGGATTAGTAGCGGG-1	Subplate
AAGCGAGGTTCGGTAA-1	Deeper Layer
AAGACATAGTTACCGG-1	Upper Layer
AAGGTATAGGACACTT-1	Ependymal cells
AAGCTTGGTTTGCAGA-1	Upper Layer
AAGTGAAGTGATCATG-1	V-SVZ
AAGTTACGTGTAACCA-1	RG, Astro, OPC
AAGGTATAGGTTACGT-1	Deeper Layer
AACTCACAGATGGAGC-1	V-SVZ
AAGCGGGTCATGCTAA-1	Interneurons1
AAGCTATGTTACATCC-1	Ependymal cells
AAGGAAGCACCAACCG-1	IPC
AAGCAAGTCTGTTCAT-1	V-SVZ
AAGACCAAGTCAGTAC-1	Interneurons2
AAGGATTAGGTTAGAG-1	Upper Layer
AAGACATAGGCTGTCA-1	Upper Layer
AAGTGTTGTTGAAGCC-1	Interneurons1
AAGCTAGAGGCCTAAT-1	Subplate
AAGGCCCTCTCTAGCC-1	V-SVZ
AACTGTTCACTTAGGC-1	Ependymal cells
AAGCGAATCGACAAAG-1	Upper Layer
AAGTGAAGTGCATTAG-1	Interneurons1
AAGGAAGCAGGCTTCG-1	V-SVZ
AAGTGCAAGCTGGCTA-1	Deeper Layer
AAGGATGTCCGGCTAA-1	Upper Layer
AAGTGTTGTACCCACC-1	Upper Layer
AACTCACAGTTTGCGG-1	RG, Astro, OPC
AAGCCTTAGCTGGACC-1	Interneurons1
AAGTGCAAGTCATTGA-1	V-SVZ
AAGAATCAGGCTAAGA-1	Deeper Layer
AAGACATAGAGAGCCG-1	Interneurons1
AAGCTTGGTCAATACG-1	Upper Layer
AAGACAAGTTTGCGAA-1	Ependymal cells
AAGACCAAGCGAAGTA-1	Deeper Layer
AAGGATGTCCGCACAA-1	Interneurons2
AAGGTCAAGGCTTAAC-1	Deeper Layer
AAGTTACGTATTGCAG-1	V-SVZ
AAGTGCAAGGGTCCAC-1	Deeper Layer
AAGTTAGCAATAATCC-1	RG, Astro, OPC
AACTTAGTCCCGCATT-1	RG, Astro, OPC
AAGCCTTAGTAAGTGG-1	Upper Layer
AAGTGCAAGAATCGCT-1	Upper Layer
AAGAATCAGTGTTGTA-1	V-SVZ
AAGTCTATCCAGCACA-1	Deeper Layer
AAGCCTCCATGTCAGC-1	Upper Layer
AAGCGAATCCCTGGTT-1	IPC
AAGCCTGTCGGCTATG-1	Interneurons2
AAGCAAGTCGCTAGTG-1	Deeper Layer
AAGTGTTGTGCTTACT-1	RG, Astro, OPC
AAGTGTTGTTTGCTGT-1	V-SVZ
AAGTTACGTCCTAAGA-1	Upper Layer
AAGCGCTGTCAAGTGC-1	Interneurons1
AAGCCACGTGTTGCTT-1	Upper Layer
AAGACCAAGCACTAAC-1	Ependymal cells
AAGCTTGGTAACGTGC-1	RG, Astro, OPC
AACTGTTCATAATCGT-1	Deeper Layer
AAGCGGGTCCTGGTCT-1	V-SVZ
AAGACATAGGACTTAC-1	Deeper Layer
AAGCGAGGTGCATCGG-1	RG, Astro, OPC
AACTCACAGTCATTGA-1	Upper Layer
AAGCATGAGGTCCTGA-1	IPC
AAGCGTTTCTTGTTCG-1	Ependymal cells
AAGCGTTTCTAAGGAG-1	V-SVZ
AAGACCAAGCAGGCCT-1	RG, Astro, OPC
AACTTAGTCATTTGTC-1	Upper Layer
AAGCTCCCACAGGAAT-1	Ependymal cells
AAGTAGCCAGCTCATA-1	Deeper Layer
AAGGAAGCACAGGATG-1	V-SVZ
AAGCGGGTCCAGGTCA-1	Subplate
AAGTTAGCAGCATTAT-1	Deeper Layer
AAGCCTGTCCTAGTCC-1	V-SVZ
AAGTGCAAGCAGGCCT-1	Interneurons1
AAGCTAGAGGTTACGT-1	Upper Layer
AAGAACAGTCAGGCAT-1	Interneurons1
AACTTAGTCACAAGCT-1	V-SVZ
AAGCGAGGTGTTGCTT-1	Ependymal cells
AAGCTAGAGGGACCTC-1	Deeper Layer
AACTAGTGTTTGCGAA-1	Interneurons1
AATGTCATCCCTGGAA-1	Interneurons2
AATGTCATCGGTTTGG-1	Deeper Layer
AATGCATGTTGTTGTC-1	V-SVZ
ACAACATGTGCTGGTG-1	Upper Layer
AATAACCGTGTGAGGA-1	Deeper Layer
AATCATCCACAAAGGT-1	V-SVZ
AATGGCGCAATTATGC-1	Interneurons2
AATGCATGTCAGGCAT-1	Deeper Layer
AATGTCCAGTTAGCTA-1	RG, Astro, OPC
AATTGCCAGTATCGCG-1	Deeper Layer
AATTGCTCACGTAAGG-1	RG, Astro, OPC
AATCGCCCATAAGGAC-1	Ependymal cells
AATTGCCAGTTTGAGC-1	Upper Layer
AATTGCCAGTCACGAT-1	Cajal-Retzius
AATTGTGTCACGTTAA-1	Upper Layer
AATTTGGTCCTGCGAA-1	V-SVZ
AATGTCCAGTACTGGT-1	Interneurons3
AATGTCATCCTGCGAA-1	Deeper Layer
AATCCGTAGTATTGCA-1	V-SVZ
AATTGGACAAACCTTG-1	Interneurons2
AATTGACGTTACTAGG-1	Upper Layer
AATGTCCAGCATTATG-1	IPC
AATGCGCGTTACGCGG-1	Upper Layer
AATTGTGTCAAATCGC-1	Upper Layer
AATCATCCATGAGCAG-1	Interneurons1
AATGTCCAGGGATGCG-1	Deeper Layer
AAGTTTGTCCGCCTAT-1	Cajal-Retzius
AATCTTGAGGTAGCTT-1	Upper Layer
AATCCCTGTTTGCTGT-1	RG, Astro, OPC
AATGTCCAGATAAAGC-1	V-SVZ
AATTGTGTCCTGTTCA-1	Upper Layer
AATAACCGTAAGCTCA-1	Upper Layer
AATGCATGTGATCAGC-1	Upper Layer
AATAGAGGTCGTAAAT-1	Deeper Layer
ACAAACTGTTGCAATG-1	IPC
AATCGCCCAGATAGAC-1	Upper Layer
AATAGCTGTGATGATT-1	V-SVZ
ACAAAGGTCTTGCAGG-1	V-SVZ
AATCCTAAGCAAGGTA-1	Ependymal cells
AATCCGTAGTTAGCCG-1	Upper Layer
AATTGCTCAGTCTAGC-1	RG, Astro, OPC
AATTAGGCATTATGGT-1	Upper Layer
AAGTTAGCAGGTCCTG-1	Upper Layer
AATTACCCAGGCCTTG-1	Cajal-Retzius
ACAACATGTGTTGTGA-1	Upper Layer
AAGTTTGTCAAATCGC-1	Upper Layer
ACAACATGTACCGGAT-1	RG, Astro, OPC
AATTAGGCACAAAGAC-1	Upper Layer
AATATCCCACACTAAT-1	Upper Layer
AAGTTTGTCTCACAAA-1	Interneurons1
AATGTCATCTCACACC-1	Deeper Layer
ACAACAACAGAATGAC-1	Deeper Layer
AATTTCCTCCGTTAAA-1	Interneurons1
AATGGCGCACATAGCC-1	Subplate
AATTACCCAGGGAGGA-1	Interneurons1
ACAACATGTGTTGCAA-1	Upper Layer
ACAAAGGTCACCGGTA-1	Upper Layer
AATCCGTAGAAGCTAG-1	Upper Layer
AATCATGTCCAGGTTG-1	Interneurons2
AATCATCCAGTTATCG-1	Upper Layer
AAGTTTGTCATTACAG-1	Deeper Layer
AATCCATCACTCGCTC-1	Interneurons1
AATATCCCAATTGCGC-1	Upper Layer
ACAAACTGTTCTTTAG-1	Subplate
AATCATCCATCCCGCT-1	RG, Astro, OPC
AATGCATGTTGGTTCT-1	V-SVZ
AATACCGGTGGTGAGA-1	Interneurons3
AATGTCCAGTGCACGC-1	RG, Astro, OPC
AATATCCCAGCATTAT-1	Interneurons1
AATAGCTGTTGCTGGG-1	Deeper Layer
AATAGAGGTGCATCGG-1	Upper Layer
AATCGCCCACCCTCAC-1	Interneurons2
AATAACCGTAACGTGC-1	Interneurons2
AATGGCGCAGGCATCT-1	Upper Layer
AATAACCGTTACTAGG-1	V-SVZ
AATATCCCAGCAAATA-1	IPC
AATTTGCCATTAGCCA-1	Interneurons2
AATGGCGCAGGCTAGA-1	Deeper Layer
AATTGCCAGCCTGATG-1	Upper Layer
AATAACCGTCCACAAA-1	Upper Layer
AATTGCTCACAGCCTG-1	Deeper Layer
AATCCATCAGGCTACT-1	V-SVZ
ACAACAACAATCTCTC-1	Deeper Layer
AATGTCCAGAACCTGT-1	Upper Layer
AATCCGTAGTGTGATC-1	V-SVZ
AATTGTGTCGCTTCTA-1	Deeper Layer
AATCAGGAGTTAACCA-1	RG, Astro, OPC
AATATCCCAACCTGGT-1	RG, Astro, OPC
ACAACAACAATTTAGC-1	RG, Astro, OPC
ACAGGATCACACCAAC-1	Interneurons1
ACCAGGCTCTTGAGGT-1	Upper Layer
ACCCAACCAACCTAAT-1	RG, Astro, OPC
ACAGCGCTCCCGAACA-1	Upper Layer
ACCAAGTTCTTCAATC-1	RG, Astro, OPC
ACCATTAAGCACAGAA-1	IPC
ACCAGGGAGGAAACTG-1	V-SVZ
ACACTTGCAATAAGCA-1	RG, Astro, OPC
ACACTTAAGGGCTAAA-1	Interneurons2
ACAGCGCTCTGTGAGT-1	Ependymal cells
ACATAGCTCAGCACCA-1	Interneurons1
ACACCTTGTCTTTATG-1	Deeper Layer
ACCATTAAGCCGCAAC-1	V-SVZ
ACCCGGTAGGACTTAC-1	Upper Layer
ACCAGCTCATGATTGT-1	Interneurons1
ACCAGGGAGACAACGA-1	Deeper Layer
ACAGTATGTTAGCCAA-1	Interneurons2
ACCAAGCGTCCAAATG-1	V-SVZ
ACAGCGCTCGGTTACG-1	V-SVZ
ACACTTGCAAGTAAGC-1	Upper Layer
ACCCGGTAGCTTACTT-1	RG, Astro, OPC
ACATTAGTCACAGGAA-1	Interneurons2
ACCCGGTAGTATGTGC-1	RG, Astro, OPC
ACCAATATCGATTTGA-1	RG, Astro, OPC
ACCACACCATCACAGC-1	Upper Layer
ACACTAATCATGCGTG-1	Deeper Layer
ACCAGGACAGAAACGT-1	Deeper Layer
ACACCTTGTTTATGGG-1	Deeper Layer
ACAGGAATCATGAAGG-1	V-SVZ
ACCAAGCGTTGTTGCT-1	V-SVZ
ACCAAACTCCTCACAC-1	Deeper Layer
ACACCTTGTGTTGCAA-1	Upper Layer
ACAGCGCTCAATGTGC-1	Deeper Layer
ACCAGGACAATAACGA-1	Interneurons1
ACAGGATCATCATGTG-1	Upper Layer
ACCAAACTCGCTAGAT-1	Interneurons2
ACACGGACAAACCTTG-1	Deeper Layer
ACATCAATCGGTACGC-1	Upper Layer
ACCAGGACACCTCAGG-1	Deeper Layer
ACACTTAAGGTCATTA-1	Interneurons2
ACACTTAAGTAATCCA-1	Deeper Layer
ACACTAATCGCATTAA-1	Upper Layer
ACAGCCGGTACGGTAC-1	Interneurons2
ACAGGAATCTTGGACG-1	Deeper Layer
ACCATTAAGGTCAAAG-1	Deeper Layer
ACCAGCTCACTAAGCC-1	Interneurons1
ACATCAATCGAGCAAA-1	Upper Layer
ACCCGGTAGCCTGATG-1	V-SVZ
ACCAGGGAGCAATAGG-1	Upper Layer
ACCCAACCATTAAACC-1	IPC
ACACTAATCCATCAGG-1	V-SVZ
ACCAATATCGGTTACG-1	RG, Astro, OPC
ACCAAGCGTTGACTTC-1	Deeper Layer
ACCACATAGCACAGAA-1	Interneurons1
ACCAAGTTCCAAGTTA-1	Deeper Layer
ACCCGGTAGCGAGGTG-1	Interneurons2
ACAGGATCACTGGCTG-1	Deeper Layer
ACCACATAGCGAGGTG-1	V-SVZ
ACCAAGCGTAAAGCGG-1	V-SVZ
ACCCGCTGTTCCATTA-1	Deeper Layer
ACCATAATCCAGCACA-1	RG, Astro, OPC
ACCAAGCGTTTGGCTT-1	Upper Layer
ACATCAATCCGGTTGA-1	Upper Layer
ACATCAATCCCTCATA-1	IPC
ACACTAGGTTAGAGCC-1	Upper Layer
ACATAGCTCGGTTTGG-1	Deeper Layer
ACAGGATCAGACAAAC-1	Deeper Layer
ACCCGGTAGTAGAGGC-1	Upper Layer
ACCAGCTCACCCTCAC-1	Upper Layer
ACCAGGACAGGCGATA-1	Upper Layer
ACCAAGCGTGCCGCAA-1	V-SVZ
ACCAGGCTCATGCTCC-1	Deeper Layer
ACAGTATGTTGGATAT-1	Upper Layer
ACCCAGGGTGTAACCA-1	Upper Layer
ACATTAGTCAGTGAAG-1	Subplate
ACCAAACTCTCACTAT-1	Upper Layer
ACATAGCTCTCCATGC-1	Cajal-Retzius
ACAGGATCAGGCTAGA-1	V-SVZ
ACCCGGTAGATAAAGC-1	IPC
ACCAGCTCAGGCTTGT-1	V-SVZ
ACATCATCAACAGGTG-1	Upper Layer
ACACTTAAGTTGTCTT-1	Upper Layer
ACCAGCTCAATAACCT-1	Deeper Layer
ACATCAATCTTAGCGG-1	Deeper Layer
ACATTGCAGATTGAGG-1	RG, Astro, OPC
ACATTGCAGTCAATCA-1	Deeper Layer
ACCATTAAGTAAGTGG-1	Deeper Layer
ACATCATCAGTAAAGC-1	Deeper Layer
ACACTAGGTCAAACTG-1	IPC
ACACTAATCACTAATG-1	Microglia
ACACTTGCAGCAAGTG-1	Deeper Layer
ACGCCACAGGTCCACA-1	Deeper Layer
ACCCGTAAGTGCTGTG-1	Cajal-Retzius
ACGCTTGAGTTCCCAC-1	Upper Layer
ACGGTTTAGTTCCCAC-1	Upper Layer
ACCCTCCCACAAAGAC-1	Interneurons1
ACCTTCCAGCTAATCA-1	Upper Layer
ACGCACGGTGCCTCAC-1	V-SVZ
ACGCCACAGGCTTAGT-1	V-SVZ
ACCTTCCAGGATTTGC-1	Upper Layer
ACGAGTAAGTGTGATC-1	Upper Layer
ACGCAAGCAATAACGA-1	Upper Layer
ACGCCTTTCCTGCGAA-1	Cajal-Retzius
ACCGGTTCAAGATTCT-1	IPC
ACCTAAGGTCCTTTAA-1	Deeper Layer
ACCTCACTCCAAGTGT-1	Upper Layer
ACGAAGTCACCCACCT-1	IPC
ACCTCACTCCACCTGT-1	Interneurons2
ACGAACAAGTTATGTG-1	Upper Layer
ACCGAAGCATTGACAT-1	V-SVZ
ACCCTGTTCAGGAACA-1	Upper Layer
ACCTACCTCACGAATC-1	Deeper Layer
ACCCTCCCAATAATCC-1	V-SVZ
ACCGAAGCATGCAACC-1	Ependymal cells
ACCTGGATCCTCATCA-1	Upper Layer
ACCTGGATCTAATCCT-1	RG, Astro, OPC
ACCTACCTCGCAAACT-1	RG, Astro, OPC
ACGAAGTCACCTCAGG-1	Interneurons2
ACGGTTTAGGAACCGG-1	V-SVZ
ACCGGCTAGGCCGGAA-1	Deeper Layer
ACGCACGGTATTGTCC-1	Ependymal cells
ACGCCTAAGTTAGCCG-1	Upper Layer
ACCCTGTTCTACCTGC-1	Interneurons2
ACCTAAGGTCTTGCAT-1	Interneurons1
ACCTACCTCCACCTGT-1	V-SVZ
ACCGGCTAGGTACCGC-1	RG, Astro, OPC
ACCTTGTGTGTCACGG-1	V-SVZ
ACGAGTAAGGAAGCTA-1	Upper Layer
ACCGGTTCATTAAAGG-1	RG, Astro, OPC
ACGCAAGCAGTTTGGC-1	RG, Astro, OPC
ACGTACCCAAACTGTT-1	V-SVZ
ACGGTTAGTATGGTGC-1	RG, Astro, OPC
ACGTACCCAACCGCCA-1	Upper Layer
ACGCCACAGAAGGTGC-1	Upper Layer
ACCGGCTAGTAACGAG-1	Interneurons1
ACGAAGTCAGGACCAA-1	Upper Layer
ACCTTGCTCGTGCTAG-1	Interneurons2
ACGCACGGTAACCACA-1	RG, Astro, OPC
ACGGTTTAGCGCTCAA-1	RG, Astro, OPC
ACCTGTTGTATGGTGC-1	Interneurons1
ACGCACGGTCATGCCC-1	Interneurons2
ACCTTCCAGCGGATAA-1	Interneurons2
ACCCTGTTCAATGTGC-1	Deeper Layer
ACGCAAGCACTTAGGC-1	Interneurons2
ACGGTACGTCCTAATC-1	Interneurons2
ACGGTTAGTTAACGGC-1	V-SVZ
ACCTGTTGTTGGTTGA-1	Interneurons2
ACCTGGTCAACCCTCC-1	Upper Layer
ACCTTCATCCCGAACA-1	Interneurons2
ACCGGCTAGCTTTGGG-1	RG, Astro, OPC
ACGAAGTCAGGTTCAC-1	Deeper Layer
ACCTGGTCAAACCTTG-1	Upper Layer
ACGGTTTAGGAAGCTA-1	IPC
ACCTGTTGTACCAGGT-1	Subplate
ACGAATCTCTATCGCC-1	V-SVZ
ACCTAAATCAGCAAAG-1	V-SVZ
ACGAACAAGGTTACGT-1	RG, Astro, OPC
ACGCAAGCAAGGTATA-1	Interneurons1
ACCTGTTGTTCACCAT-1	V-SVZ
ACGAACAAGCGCCTTT-1	Upper Layer
ACCGCAATCATTTAGG-1	Deeper Layer
ACCTTCATCGTTAGTA-1	Upper Layer
ACCGCAATCGATTATG-1	Upper Layer
ACCTGGATCGCCTAAG-1	Interneurons1
ACGGTTAGTTTCCACG-1	V-SVZ
ACGCACGGTTATCCTA-1	Upper Layer
ACGGTACGTGATTTGG-1	Ependymal cells
ACCTGGTCAGTAGCCT-1	V-SVZ
ACCTACCTCACCTGTC-1	Ependymal cells
ACGCTTGAGTTGTCTT-1	Interneurons1
ACCTGGATCACCGGTA-1	V-SVZ
ACGCCACAGAGGGACT-1	Upper Layer
ACCTAAATCGAGGAGT-1	Ependymal cells
ACGAATCTCCCGCATT-1	Deeper Layer
ACGGTTAGTTGTAAAC-1	V-SVZ
ACGCAAGCATGTTGGC-1	V-SVZ
ACCTGTTGTTGGCGTG-1	V-SVZ
ACGAAGTCAAGCTTAT-1	V-SVZ
ACCGGCTAGCGCTCAA-1	IPC
ACCGAAGCATTGGGAG-1	Interneurons1
ACCTCACTCTGGCAAT-1	RG, Astro, OPC
ACCTTGTGTATTGCAG-1	IPC
ACTTATCTCGGTTCCT-1	RG, Astro, OPC
ACTAACTCATTGCGGT-1	Upper Layer
ACTAATCCATGTTTGG-1	Deeper Layer
ACTATGTCAGGACCTT-1	V-SVZ
ACTCACTGTTATCCTA-1	IPC
ACTCGCTTCGCATCCT-1	Deeper Layer
ACTTATGAGTTGCGTG-1	Deeper Layer
ACTATGTCAGAAATGC-1	Interneurons3
ACTTATCTCATGTCAA-1	Interneurons2
ACGTTGTAGCACTAAC-1	V-SVZ
ACGTCCTTCACTAATG-1	RG, Astro, OPC
ACTGAATGTAGCCATA-1	Interneurons1
ACTAGGCGTTTGGTTC-1	Deeper Layer
ACGTTGTAGGAGGGTT-1	Upper Layer
ACGTTGTAGTAACGGA-1	Subplate
ACTTGTAAGCACTAGT-1	Interneurons1
ACTTATGAGTCACCTC-1	Deeper Layer
ACGTCAAGTACAAAGA-1	Deeper Layer
ACTCCTCAGTATTGCA-1	Deeper Layer
ACTCGCTTCGACAAAG-1	Deeper Layer
ACTAACTCACCAAAGG-1	RG, Astro, OPC
ACGTCAAGTTACGCGG-1	Upper Layer
ACTAACTCAGGAACAT-1	V-SVZ
ACTAACCAGCCACAAT-1	V-SVZ
ACTGAATGTTAGCAGC-1	Upper Layer
ACTCGCTTCAAACTCA-1	RG, Astro, OPC
ACTATCCGTCATGAGC-1	Upper Layer
ACTTATCTCTAACCTT-1	V-SVZ
ACTTATCTCGCGCTAA-1	Upper Layer
ACTTAGGGTAACGGGA-1	Deeper Layer
ACGTTGTAGCACTTGG-1	Upper Layer
ACTCACTGTAAGCTCA-1	Interneurons1
ACGTTACAGGCCTAAT-1	Deeper Layer
ACTCGCGCAGTTTACG-1	Deeper Layer
ACTATGTCATGAGCAG-1	Deeper Layer
ACTTAGTCATTTGCTC-1	V-SVZ
ACGTCCTTCAGCAAGA-1	Ependymal cells
ACTTAGGGTAATCGTG-1	RG, Astro, OPC
ACTTGAATCGGGCCAT-1	Upper Layer
ACGTTGTAGACAAACG-1	V-SVZ
ACTCAGTAGCAAGATG-1	Deeper Layer
ACTTGTAAGCGGATTT-1	Deeper Layer
ACTAAAGCAAACTCAT-1	Deeper Layer
ACTGAATGTCACAAAT-1	V-SVZ
ACGTCCAAGGGACCTC-1	Cajal-Retzius
ACTTGTAAGTGTGATC-1	IPC
ACTAACCAGCTTAACA-1	Deeper Layer
ACTGAATGTGATTACG-1	Deeper Layer
ACTTAGTCATGATTGT-1	Deeper Layer
ACTAAAGCAGTTAAAG-1	RG, Astro, OPC
ACTCACTGTGGTTATG-1	V-SVZ
ACTTAGTCATCATGTG-1	Deeper Layer
ACTTATGAGCGAGTAA-1	Ependymal cells
ACGTCAAGTGGCTTCC-1	Ependymal cells
ACTCGCTTCTTTGAGA-1	V-SVZ
ACTCAGTAGCCGCTTT-1	Deeper Layer
ACTCGCTTCCTTCTAG-1	V-SVZ
ACTCGCGCATCAATCG-1	Interneurons2
ACTCGCGCAGTGAACG-1	Upper Layer
ACTATCCGTCGTAAAT-1	Upper Layer
ACTCAGTAGCCAGGTC-1	RG, Astro, OPC
ACTTACTTCCACCTGT-1	RG, Astro, OPC
ACTAACTCATTGTGGC-1	Deeper Layer
ACTCCTCAGGCCCAGT-1	Subplate
ACTTATCTCTCACTAT-1	Upper Layer
ACTTGTCGTCTTTGAC-1	Microglia
ACTTAGTCAAGGGTTG-1	Ependymal cells
ACTTAGTCATTGGGAG-1	Upper Layer
ACTGAAACAACACCTA-1	Deeper Layer
ACTGAATGTAGGTTGC-1	Interneurons2
ACTAACTCACCCACAG-1	Deeper Layer
ACTCGCGCAACCCTAA-1	Deeper Layer
ACGTCAAGTGTTTCAC-1	Upper Layer
ACTTGCACAACCTGGT-1	Upper Layer
ACTTAGTCACCTATAG-1	Upper Layer
ACTCGCGCATAGCGAG-1	Deeper Layer
ACTCACCTCACGCGGT-1	V-SVZ
ACGTTACAGGCCATCA-1	V-SVZ
ACTTACTTCGCTCACT-1	Upper Layer
ACTAACTCAAGTGAAC-1	Deeper Layer
ACTAAAGCACAATACT-1	Interneurons2
ACTTAGGGTGATTACG-1	Deeper Layer
ACTCAGTAGGATCACT-1	Upper Layer
ACTTTGTTCCACCCTG-1	Upper Layer
ACTAATCCAGTTTCTC-1	Upper Layer
ACTCGCTTCAGGCCTA-1	IPC
ACTCCTCAGAGGAGTC-1	Interneurons1
ACTCAGTAGTTACTTC-1	V-SVZ
ACTTAGGGTTGGCGTG-1	Interneurons1
ACTAGGCGTCCTCCAA-1	Deeper Layer
ACTTATCTCGCTCACT-1	Interneurons3
ACTAACTCAGCATGGA-1	RG, Astro, OPC
ACTCACCTCATTGCAA-1	RG, Astro, OPC
ACTGAATGTTAATCGG-1	Upper Layer
ACTATCCGTATCTGGA-1	RG, Astro, OPC
ACTGAAACAATACTGT-1	Deeper Layer
AGCAAGGGTGGCTTCC-1	Interneurons2
AGAATCTGTGTGTGGT-1	RG, Astro, OPC
AGAACCAAGCAGGCCT-1	Ependymal cells
AGAAAGGCAGTTTCTC-1	RG, Astro, OPC
AGCACTTAGGAGGGTT-1	Deeper Layer
AGAGAGGAGCAACAAG-1	Deeper Layer
AGAACAAGTGACCTGG-1	Upper Layer
AGAATCGAGTTAACCA-1	Upper Layer
AGCAATTGTGTCCTGC-1	Interneurons3
AGAAGGTGTTAATGAC-1	Upper Layer
AGCAACAAGCTGGACC-1	RG, Astro, OPC
AGAACCGCATTAGCCA-1	Upper Layer
AGCCAGTGTTAACGGC-1	Upper Layer
AGACAATAGGTAAGCA-1	Upper Layer
AGAGGATGTAATGGCC-1	Cajal-Retzius
AGAACAAGTTGTAAAC-1	Interneurons1
AGAGAAGCAGAAATTG-1	Interneurons1
AGCCTAGTCTGCAACG-1	Upper Layer
AGCACTAGTCGTTACT-1	Deeper Layer
AGAGAAGCACCTCGCT-1	Upper Layer
AGAAAGGCACCCTCAC-1	Interneurons1
AGAAGGTGTGGTTATG-1	RG, Astro, OPC
AGCCTAAGTAAGTCGC-1	IPC
AGCAATACAGGCTACT-1	V-SVZ
AGCATCCCAGCAAGTG-1	Subplate
AGCCTCCGTAAAGCAA-1	V-SVZ
AGATGAAGTTACCGGG-1	Deeper Layer
AGATGCTTCCGGCTAA-1	Ependymal cells
AGAAACTAGCCTGTTC-1	Interneurons2
AGCACTAGTTGTTGCT-1	V-SVZ
AGCAACAAGGAGCACG-1	V-SVZ
AGATGCTTCTTGCAAA-1	Deeper Layer
AGAGGAACATAGACCC-1	RG, Astro, OPC
AGATGAAGTGCAATAT-1	V-SVZ
AGAGGATGTAGGATTT-1	Cajal-Retzius
AGACCCGGTAGGTGTC-1	Upper Layer
AGACCCGGTTACTTGC-1	Subplate
AGAGAGGAGGTTTGCG-1	IPC
AGCCGGTTCGATTTGA-1	V-SVZ
AGAGAAGCATTGTCAG-1	V-SVZ
AGCATTTCACACTAAT-1	Interneurons1
AGAGAAGCATTAAAGG-1	RG, Astro, OPC
AGCCGGTTCGGTACGC-1	V-SVZ
AGCACAGCAGGATTAA-1	Deeper Layer
AGCCGCTAGTTTAACG-1	RG, Astro, OPC
AGACACGCACAGCCTG-1	V-SVZ
AGAGAGGAGTAGGATG-1	RG, Astro, OPC
AGCAGGTAGCTGTCAG-1	V-SVZ
AGCATCCCAAGGTCCT-1	Ependymal cells
AGATGAAGTTAGGTTG-1	V-SVZ
AGATGCTTCCACAATA-1	Upper Layer
AGCAAATAGAGCAAGC-1	V-SVZ
AGCCGGTTCTGGCAAT-1	V-SVZ
AGCATTTCATTGCAGC-1	V-SVZ
AGAACCGCAGCTTACA-1	Upper Layer
AGACAATAGCATCCAG-1	RG, Astro, OPC
AGATGCTTCTAAGGTC-1	Upper Layer
AGCAAGGGTCAAGACC-1	RG, Astro, OPC
AGACTATGTCCTGATT-1	Deeper Layer
AGAGATTAGCCTAATA-1	Interneurons2
AGACACGCAAGCTACC-1	Deeper Layer
AGACACGCAGCTCATA-1	Interneurons1
AGCAATTGTTTGGCGG-1	Upper Layer
AGACACGCATGGTTAT-1	Ependymal cells
AGAATCGAGCTCATAA-1	RG, Astro, OPC
AGCATCCCAGGGAGGA-1	Upper Layer
AGAGAAGCACCAGGTT-1	RG, Astro, OPC
AGAACAAGTGATCATG-1	RG, Astro, OPC
AGCACAGCATGCTCCC-1	Ependymal cells
AGAACCGCAAGTTATC-1	Deeper Layer
AGAAGGTGTGTTTGTC-1	V-SVZ
AGCACTTAGAGGAGGA-1	V-SVZ
AGCAAATAGCCAGGTC-1	Upper Layer
AGACTATGTTTACGTC-1	Upper Layer
AGCATTTCAGGGAGGA-1	Interneurons1
AGACAATAGTTCCCAC-1	Upper Layer
AGCAATACAATCATGT-1	V-SVZ
AGCCTCCGTTAATCGG-1	V-SVZ
AGAACAAGTTACCGGG-1	Interneurons2
AGCCGCTAGGTAACGA-1	Deeper Layer
AGCCTAGTCGAGGAAC-1	IPC
AGAGGATGTGATGGCT-1	Deeper Layer
AGCATTTCAGGCTTGT-1	RG, Astro, OPC
AGCAGGTAGTTGGGCC-1	V-SVZ
AGCAAGGGTTTGCTGT-1	Upper Layer
AGAAGGTGTGCTTAGA-1	Upper Layer
AGAACAAGTTCGCTTG-1	Deeper Layer
AGAAACTAGGACGTAA-1	V-SVZ
AGCAATACAGTTTGGC-1	V-SVZ
AGCACTAGTCACCTAT-1	Upper Layer
AGAGGAACAGGCCATT-1	IPC
AGCCGGTTCCGGAACC-1	Microglia
AGCTAAACAGCTAATT-1	Deeper Layer
AGCTACGTCATTGCAA-1	Upper Layer
AGCGGATAGGGTGGAT-1	Interneurons1
AGCTACTAGTAGAGGC-1	Deeper Layer
AGCTTTAAGACCATAC-1	Upper Layer
AGCTACGTCGTAATCA-1	Upper Layer
AGGATGTCAGGTATTT-1	RG, Astro, OPC
AGGAACGGTCTTTGAC-1	RG, Astro, OPC
AGCTACGTCATTAGTG-1	Upper Layer
AGCGGACCACTAAGAA-1	Interneurons2
AGCTGCTCAAATGCCC-1	RG, Astro, OPC
AGCTTAATCGGTTAGT-1	Upper Layer
AGCTAGTTCAGCATTA-1	Upper Layer
AGGATATAGATGCCTG-1	V-SVZ
AGGCAATCAGGATGGC-1	RG, Astro, OPC
AGCTAGTTCGCAATCG-1	V-SVZ
AGCTTAATCCCTGATC-1	V-SVZ
AGGAACCAGCGAAGTA-1	Interneurons1
AGCTTAATCCACCCTG-1	Interneurons2
AGCGGATAGTAACCCG-1	RG, Astro, OPC
AGGCAGGTCACTCGCT-1	Deeper Layer
AGGCAATCACCTACTT-1	Upper Layer
AGCTAACTCGGGATTT-1	Deeper Layer
AGCTATATCCCTGGAA-1	IPC
AGCCTGGGTTAGGACC-1	Ependymal cells
AGCGATTTCAAACCGT-1	RG, Astro, OPC
AGCTAACTCCTGGCTT-1	Deeper Layer
AGGACGTAGGACCAGG-1	V-SVZ
AGGATGTCAACTAACT-1	Upper Layer
AGGACTAAGGAGTAAT-1	Subplate
AGCTGCTCATAGCGAG-1	Upper Layer
AGCTACTAGGACTAAG-1	Interneurons2
AGGATGTCACAACCTA-1	V-SVZ
AGCTAGTTCCTAGTAA-1	V-SVZ
AGGCAATCAGTTAAAG-1	Deeper Layer
AGGATTGAGTAACGAG-1	IPC
AGGATCCGTCAATGTG-1	Upper Layer
AGGATATAGGCTGGCT-1	Deeper Layer
AGGCAATCAGGCGAGT-1	V-SVZ
AGGATTGAGTCACCTC-1	Deeper Layer
AGCTGCTCAATATGGA-1	Ependymal cells
AGGATATAGGCGCTTA-1	RG, Astro, OPC
AGCGCTCAGGCTATGT-1	RG, Astro, OPC
AGCTATATCATTCATC-1	Ependymal cells
AGCGGACCATGGTTAT-1	Interneurons2
AGCGTGCTCCTAAATG-1	Upper Layer
AGCGATTTCTGTGAGT-1	Interneurons3
AGCGGATAGTTATCCT-1	V-SVZ
AGCTCATAGCGTGCGT-1	RG, Astro, OPC
AGCGCTCAGGCTACAT-1	RG, Astro, OPC
AGGAGCTAGCATTAGC-1	Cajal-Retzius
AGCTTCCTCGTTCACC-1	Upper Layer
AGGCAATCATAATTGC-1	Deeper Layer
AGGCAATCACTAGCGT-1	Upper Layer
AGCTTTAAGGCTAAGA-1	RG, Astro, OPC
AGCTCATAGTCAATCA-1	RG, Astro, OPC
AGGAAACGTCGTTATC-1	Upper Layer
AGCTACGTCCCGTTTA-1	Ependymal cells
AGCCTGGGTTTGGCGG-1	Interneurons2
AGCTTCCTCCCGTTGT-1	Deeper Layer
AGGACTAAGAATGACG-1	Interneurons1
AGCTATATCACTAGGT-1	V-SVZ
AGCGGATAGTTGTCTT-1	Interneurons1
AGGAACCAGGTAAGCA-1	Upper Layer
AGGAGCTAGGATCCGC-1	Upper Layer
AGGATGCAGAAAGGAA-1	Interneurons2
AGGAAACGTGGATTAT-1	Upper Layer
AGGATGCAGGGCTTTG-1	Ependymal cells
AGCTCATAGCTTTGTT-1	V-SVZ
AGCGCCTAGTCGCTAG-1	RG, Astro, OPC
AGCGGACCAGAGGCTA-1	V-SVZ
AGCCTGGGTCTAGCTT-1	RG, Astro, OPC
AGGATATAGTGGCGGA-1	Cajal-Retzius
AGCCTGGGTTTGGGCG-1	Upper Layer
AGCTTTAAGACACCGC-1	Deeper Layer
AGCGGATAGAAAGGAA-1	Deeper Layer
AGCTAACTCATGCTTT-1	Interneurons1
AGCGCCTAGACAAGTG-1	Interneurons1
AGGATGTCATCATGTG-1	Subplate
AGGATTGAGGCAATAG-1	Upper Layer
AGGATGCAGGCGTAAA-1	V-SVZ
AGGACTAAGCACTAAC-1	V-SVZ
AGCGTGCTCGGTTTCC-1	Upper Layer
AGGACGTAGTAACTCA-1	RG, Astro, OPC
AGCCTCCGTTTCGCCA-1	RG, Astro, OPC
AGGAGCTAGGAGCATA-1	Interneurons2
AGCTTAATCTTGACCC-1	Deeper Layer
AGCTTTAAGTTGGGCC-1	RG, Astro, OPC
AGTCGCATCGGTAACT-1	Deeper Layer
AGTACGCGTCAAGTGC-1	Interneurons3
AGTAATGCACGAATCC-1	Deeper Layer
AGGGTTGCACAAAGAC-1	Deeper Layer
AGGCAGGTCCCTCATA-1	Upper Layer
AGGTTAGAGGCCCAGT-1	Interneurons1
AGGTCTTAGACACTTA-1	Interneurons1
AGGCTAAAGGGTGAAC-1	Upper Layer
AGGTACGCAAGCCACT-1	V-SVZ
AGGTATTGTCAAGACC-1	Deeper Layer
AGTAATGCAAGTGTCC-1	Interneurons2
AGGTTAACATGCATAT-1	Interneurons3
AGGTATTGTTAGTACG-1	Deeper Layer
AGGTTAACACTAGGTC-1	Deeper Layer
AGTCCTTGTTTCGCGC-1	RG, Astro, OPC
AGGTGAATCATGTCAA-1	V-SVZ
AGTAGCTTCCGTGACA-1	Interneurons1
AGGTTAGAGTAAGTGG-1	RG, Astro, OPC
AGGCGGATCACACAGT-1	Interneurons1
AGTAGGATCCCTCACG-1	Ependymal cells
AGGTTAGAGTTACCGG-1	RG, Astro, OPC
AGGTTAACAGAAATTG-1	IPC
AGGGTTGCAATAATGG-1	Deeper Layer
AGGCGGATCACTAAGC-1	V-SVZ
AGTCTTGCATTGCGAC-1	Upper Layer
AGGTATTGTCATTAGG-1	Deeper Layer
AGGGCTACAACACTTG-1	Upper Layer
AGGTCTTAGTTGGATC-1	Interneurons2
AGGTTTGGTGTTGTGA-1	Upper Layer
AGGCTAGCACAACCTA-1	Deeper Layer
AGGCTAGCAGCATGAG-1	V-SVZ
AGTCCTGAGTAGGCGG-1	Interneurons2
AGTGAGTCAACTAGGG-1	Cajal-Retzius
AGGTGAATCTCATCAT-1	Ependymal cells
AGGTCCGGTAACTACG-1	V-SVZ
AGGTTTGGTAGCTGGT-1	Upper Layer
AGGGCTACAGCTTACA-1	IPC
AGTAACACACCTGCCT-1	V-SVZ
AGGTTACTCTCCTCTT-1	Ependymal cells
AGGTTAGAGCCGCTTT-1	V-SVZ
AGGTTGCGTCATCATC-1	Ependymal cells
AGGTTAACACAGCCTG-1	Deeper Layer
AGTAACCTCAACAAGG-1	Upper Layer
AGTAACCTCAGCTAAC-1	V-SVZ
AGGTCATTCTCACATT-1	Deeper Layer
AGTGAGTCAATTGACT-1	Upper Layer
AGTAACACACTATGGC-1	RG, Astro, OPC
AGTCGCATCATGAAGG-1	Interneurons2
AGGTTAGAGCTTCCCG-1	Interneurons2
AGTATAGCAACCCTAA-1	Interneurons3
AGGTCAAAGGTCCGTA-1	Ependymal cells
AGTAACCTCCCTCAGT-1	RG, Astro, OPC
AGGTGAATCATTACGA-1	Upper Layer
AGGGCCTTCATGCTCC-1	Upper Layer
AGTCCTTGTAATCCCT-1	RG, Astro, OPC
AGTCGCATCAGTGAAG-1	Interneurons1
AGTAGGATCAGTTCCC-1	Interneurons1
AGGGCTACATGGCCCA-1	Interneurons2
AGTAACACAATCCCTT-1	V-SVZ
AGTCAAGAGACTCGCA-1	Upper Layer
AGTCCTTGTTTCGCCA-1	Interneurons1
AGTACGCGTCGCGCAA-1	Upper Layer
AGGTAACCAATATGGA-1	Deeper Layer
AGGTTACTCATCCTGC-1	IPC
AGTAACACAGATTCAT-1	Ependymal cells
AGTCGCATCCGTGACA-1	Subplate
AGGCAGGTCCCATAGG-1	Ependymal cells
AGGTACGCAGCACGTT-1	Interneurons1
AGGTCAAAGAAACTGG-1	Interneurons1
AGGGCCTTCCGTTATT-1	Upper Layer
AGGTGAGGTGAGACTC-1	RG, Astro, OPC
AGTCCTTGTCGCGCAA-1	Deeper Layer
AGGTCTTAGGAGTCGG-1	V-SVZ
AGGTATTGTCATAAGT-1	Interneurons1
AGGCAGGTCAGAAACG-1	Interneurons1
AGGTGAATCAAGTGTC-1	RG, Astro, OPC
AGGTCAAAGCCGCAAC-1	Interneurons3
AGTCCTGAGGGATGCG-1	V-SVZ
AGGGCCTTCTTGCAGG-1	Interneurons2
AGTGAGTCACTTGTTC-1	V-SVZ
AGTGAGTCAGGTTAAA-1	V-SVZ
AGGCCCAGTACTGATG-1	V-SVZ
AGTAACCTCCTTTACG-1	RG, Astro, OPC
AGGCTAGCACCTGTAA-1	Upper Layer
AGTCGCATCGCTCACT-1	Deeper Layer
AGTAACCTCCCATAGG-1	Upper Layer
AGGGCCTTCGTTTCTG-1	Interneurons1
AGTACGCGTAGTAAGA-1	Upper Layer
AGTAACACAGGCTGTT-1	RG, Astro, OPC
AGGGCTACAAGGTCGA-1	V-SVZ
AGGCTAAAGGCGCATC-1	V-SVZ
ATATAGGCAGCTACGT-1	Interneurons1
ATCATCAAGACTATTG-1	V-SVZ
AGTGGACAGATACTTG-1	IPC
ATAACGACACTCGCTC-1	Upper Layer
AGTTGTCAGGACAATG-1	Upper Layer
ATCACAATCAACAAGG-1	IPC
AGTTTGATCGCTTCTA-1	Interneurons2
ATCAAGACATTATGGT-1	RG, Astro, OPC
ATATGCTCAGCTTAGC-1	V-SVZ
ATCACCCTCATGTCAA-1	Deeper Layer
AGTTGCAGTTGGGTTA-1	Deeper Layer
ATATGCATCTAGCGTG-1	RG, Astro, OPC
ATAGATGCAACGTGCT-1	Interneurons2
ATACCTGCAATCCTAG-1	Upper Layer
AGTTTGCAGCCTGGTA-1	Interneurons1
ATACCTGCAGGAACTG-1	RG, Astro, OPC
AGTTGTCAGCTTAGTA-1	Microglia
AGTTTGCAGCATGTCG-1	Ependymal cells
ATCAGGTTCCGTTAAA-1	Deeper Layer
AGTTTGCAGTTCCTCA-1	Upper Layer
ATAAGCCTCTCCTCTT-1	Upper Layer
ATACCTGCATGGCCCA-1	Deeper Layer
ATCACACAGTTCCCGT-1	Interneurons3
ATCAGGTTCTTAAGTG-1	Subplate
AGTGCGGAGCTGAGGG-1	V-SVZ
ATATGTCCAGCTTAGC-1	V-SVZ
ATCACACAGCACCACA-1	Upper Layer
ATAAGCCTCGAGCTAT-1	Upper Layer
ATAAGCCTCTAAGGAG-1	Deeper Layer
AGTGTTTCATAATTGC-1	V-SVZ
AGTGTGGCAACTAGAA-1	Upper Layer
ATAGGTACAAAGCTCC-1	V-SVZ
AGTTTGCAGACAGGTA-1	Deeper Layer
AGTGTGGCATAATCAC-1	Interneurons1
AGTGATGAGCATTTCT-1	IPC
ATATGCATCCCTGTTA-1	RG, Astro, OPC
ATAACGACAGGATGGC-1	Upper Layer
ATCACACAGAAGGTGC-1	Upper Layer
AGTGCGGAGCTCAATA-1	Interneurons1
AGTGCCGGTCCCGGAA-1	Upper Layer
ATATGGTGTTTGGCTT-1	Deeper Layer
ATACCGGTCTCACTAT-1	Upper Layer
AGTTTGCAGTCAGTAC-1	RG, Astro, OPC
ATCAAGCTCCAAACAC-1	Interneurons2
ATCACACAGGGATGCG-1	Upper Layer
AGTGGACAGTTGTCCC-1	Deeper Layer
ATACCGGTCGGTTAGT-1	Upper Layer
AGTGGACAGGTGTTAC-1	IPC
ATATGGTGTTATAGCG-1	Interneurons1
ATAAGCCTCGATTCTT-1	Interneurons2
ATCACTAAGTGAGCGG-1	RG, Astro, OPC
ATAAGCCTCTGTTCAT-1	Subplate
AGTGCCGGTATTACCC-1	Upper Layer
ATAACGACACAATTAC-1	V-SVZ
ATACCGGTCTTACTCG-1	Interneurons3
ATAGATGCATTAAGTC-1	Upper Layer
ATAATGGCACAGGGAC-1	Ependymal cells
AGTTGCGTCGCAATCG-1	Upper Layer
AGTTGGCGTTCACCAT-1	V-SVZ
ATAACGACATGCTATG-1	V-SVZ
ATCAAGACAGCAAGTG-1	V-SVZ
ATCACCCTCCTGCGAA-1	Upper Layer
AGTGCACGTATTGCAG-1	Deeper Layer
ATCACAATCCTAAGGT-1	Interneurons1
AGTGTTTCATGTCAAT-1	Upper Layer
ATAAGCCTCGCTCCAT-1	RG, Astro, OPC
ATAGGTACATTATGGT-1	Interneurons2
AGTGTGGCAGGATTAA-1	Upper Layer
ATACCTGCATCATGTG-1	Deeper Layer
AGTGCCGGTAATGACT-1	Interneurons2
AGTTTGATCCTGAATA-1	Subplate
ATATGCTCATCCATCT-1	V-SVZ
AGTGTTTCACCATATG-1	V-SVZ
ATAACGACATTAGGTT-1	Deeper Layer
ATAGATGCAGGCGATA-1	Interneurons2
AGTGATGAGGGACGCA-1	Deeper Layer
AGTTGGCGTAGCAGCT-1	Subplate
ATAACGACATAATCAC-1	V-SVZ
AGTGATGAGCATTATG-1	Cajal-Retzius
ATAAGCCTCCAGGGAG-1	Interneurons3
ATCATCAAGGGACTAA-1	RG, Astro, OPC
ATCACAATCGAGGAAC-1	Interneurons1
ATCACTAAGGCATGTT-1	Deeper Layer
ATATGTCCATAGTCAT-1	Interneurons3
AGTGGACAGGCTGTGC-1	IPC
AGTGCCGGTGTGAGAG-1	Deeper Layer
ATATGCATCTTGAGGT-1	Upper Layer
ATCAATCCAGCTAATT-1	Upper Layer
ATATGTCCAATTAACC-1	Deeper Layer
AGTGGACAGCGTGCAC-1	RG, Astro, OPC
ATGAATGCACGTAATT-1	V-SVZ
ATGGTGCGTGTTAAAC-1	Upper Layer
ATGGCTAGTTGCGGAT-1	V-SVZ
ATGGCTGTCATTACGA-1	Upper Layer
ATCCTGACATGACTAT-1	RG, Astro, OPC
ATGCAGGCAGTTTGTG-1	Deeper Layer
ATCCATAAGGTCCTGA-1	IPC
ATCCACCTCTCGACCT-1	Upper Layer
ATGCAAACAGGACCAA-1	Upper Layer
ATGGTGCGTCCTTCTC-1	Upper Layer
ATCCCGCGTAAAGCAA-1	Upper Layer
ATGACGAAGCGAGTAA-1	Upper Layer
ATCATGTCACAGAACG-1	RG, Astro, OPC
ATCGCTTGTAATGACT-1	RG, Astro, OPC
ATGCGATTCTGTAAGC-1	Deeper Layer
ATGTAACGTTTCCGGC-1	V-SVZ
ATGAAGTAGGTCATTA-1	Interneurons1
ATCATGTCAGCCAGTT-1	Upper Layer
ATGCAAACAGTCTATG-1	RG, Astro, OPC
ATCGCCCGTTCGCGCT-1	V-SVZ
ATCCTCATCAAGTGAG-1	Deeper Layer
ATCTTTGGTAAGCTTG-1	Upper Layer
ATGCTTAAGGTCATTA-1	RG, Astro, OPC
ATCGCCCGTGGGTGAA-1	Ependymal cells
ATCGAGGCATCAGCAC-1	Upper Layer
ATCCCGCGTGCCTCAC-1	Upper Layer
ATGAAGCCAGGAACAT-1	Deeper Layer
ATCTTTGGTGATGAAA-1	Upper Layer
ATCCACCTCAGCTAAC-1	Upper Layer
ATGAAGCCAGGACCTT-1	Ependymal cells
ATGCATTCAATAGCCC-1	Ependymal cells
ATGTAACGTAATCACG-1	Deeper Layer
ATGGTCTAGTCACTAA-1	Interneurons1
ATGGCCCAGATGGAGC-1	Upper Layer
ATGTAACGTGATTACG-1	Upper Layer
ATCGAGGCAGGTTATT-1	Subplate
ATCCTGACAGGACACA-1	IPC
ATCCGTGAGGTCCTAG-1	Deeper Layer
ATCTATGAGTTTAACG-1	RG, Astro, OPC
ATCGAGGCAGTTTGGC-1	V-SVZ
ATGCTTAAGGTCCGTA-1	IPC
ATGGTTATCTGGTCCT-1	Upper Layer
ATGACAACAGGCATGA-1	Upper Layer
ATGAAGTAGAAACTGG-1	Upper Layer
ATGGCCCAGCTGTCAG-1	Cajal-Retzius
ATCCACCTCATTGCGG-1	RG, Astro, OPC
ATCCTTAGTTGGTTGA-1	Interneurons2
ATCCGTGAGTCGCTAG-1	Ependymal cells
ATGCGATTCATGTTTC-1	Upper Layer
ATGGCTGTCCTTGTTG-1	RG, Astro, OPC
ATGCAAACATGCTTAG-1	V-SVZ
ATCGCCCGTTTGTCTA-1	Upper Layer
ATGGCCCAGCATGTTA-1	V-SVZ
ATCCCGCGTTGGTTCT-1	Deeper Layer
ATCCTGACACTTGTTC-1	V-SVZ
ATCCATAAGGATCCGC-1	Deeper Layer
ATGACCAGTTACATCC-1	V-SVZ
ATGGCTGTCACGCATG-1	Interneurons2
ATGATGGAGCTTACTT-1	Upper Layer
ATGGCTTAGCTAGAAG-1	Interneurons1
ATCCGTGAGGATGATG-1	Upper Layer
ATGATGACAATTGACT-1	RG, Astro, OPC
ATGATGGAGCGAGTAA-1	Upper Layer
ATGAAGCCACATGCTA-1	V-SVZ
ATCGAGGCAGGCGATA-1	Deeper Layer
ATGACGAAGCGCCTTT-1	Upper Layer
ATGATGACAAACAACA-1	RG, Astro, OPC
ATCGCTTGTTCATTTG-1	Interneurons2
ATGGTGCGTTACCTGT-1	Deeper Layer
ATCGGCCAGGAGCACG-1	Interneurons1
ATGTAACGTTGCACGG-1	V-SVZ
ATGCTTAAGTCATTTC-1	Deeper Layer
ATGGCTAGTGAAGCCT-1	Upper Layer
ATGACGAAGGTGAGAC-1	Interneurons2
ATCATGTCAGGCGATA-1	Subplate
ATGGCTAGTGGTTCCC-1	V-SVZ
ATGATGACACTGGCCA-1	V-SVZ
ATGGTTATCTTGCTAT-1	Upper Layer
ATGACAACACTTCATC-1	Deeper Layer
ATGGTCTAGTAGCGGG-1	Upper Layer
ATGACCAGTTAATGAC-1	Deeper Layer
ATGCCTGAGTAACCAC-1	RG, Astro, OPC
ATCGCCCGTTAGGACC-1	Interneurons1
ATGGTTATCCTCCATA-1	Ependymal cells
ATGGCTGTCAAACCTA-1	V-SVZ
ATTAGGTGTAACTACG-1	Upper Layer
ATTCAACCAGTAGGAT-1	Upper Layer
ATTGCTCGTTATAGCG-1	V-SVZ
ATGTTTGAGCCAGGTC-1	Upper Layer
ATGTTTGAGTTAGAGG-1	Interneurons3
ATTCCGGAGATGGAGC-1	Upper Layer
ATTCCTCCATGGCCTG-1	V-SVZ
ATTAGCTCAAGCCACT-1	V-SVZ
ATGTGAGAGGGTTATC-1	RG, Astro, OPC
ATTACCCGTTCACTGT-1	V-SVZ
ATGTTTGAGTCCTTCA-1	V-SVZ
ATGTTCAAGAAAGCAT-1	Interneurons2
ATTCAACCACCAACCG-1	Upper Layer
ATTGAAGCAGGCCTTG-1	Subplate
ATTAGGTGTCACAGCG-1	Upper Layer
ATTACTGAGGCTTAAC-1	IPC
ATTCACTTCTTGCATT-1	V-SVZ
ATTATGGTCACGCGGT-1	IPC
ATTGGTTCACATAACT-1	Interneurons2
ATTACGTCAATAATGG-1	RG, Astro, OPC
ATTCAACCAATTAACC-1	Interneurons1
ATTCAACCAGGACCAA-1	V-SVZ
ATTAGCTCATTAAACC-1	Subplate
ATTCAACCAGAGAGCC-1	RG, Astro, OPC
ATGTCAATCACTTCAT-1	RG, Astro, OPC
ATTAGTCCACTTAACG-1	Upper Layer
ATTCATGAGCTTTGGG-1	RG, Astro, OPC
ATGTCCACAATTGAGA-1	Ependymal cells
ATTAGCGGTGCATCGG-1	RG, Astro, OPC
ATGTCCACAGTAAAGC-1	Interneurons2
ATTACCGCAAACGCGA-1	Upper Layer
ATTCCTAGTGAATCGC-1	Deeper Layer
ATTGAAGCATTGTCCT-1	Ependymal cells
ATGTAAGCAGGAACCA-1	Upper Layer
ATTAGCTCATTGTGCA-1	IPC
ATGTCAATCTTTGACT-1	V-SVZ
ATTGACTCAAACCTTG-1	Interneurons1
ATTCCTCCACCTCACC-1	Deeper Layer
ATTGAAGCATCACAGC-1	Subplate
ATTAGCGGTCAAAGGG-1	Upper Layer
ATTGCGCCATTAAGTC-1	IPC
ATTGCTCGTCTAACAG-1	RG, Astro, OPC
ATTCACTTCTGGTCCT-1	RG, Astro, OPC
ATTCGTTTCCTTAAGA-1	RG, Astro, OPC
ATGTGAGAGTCATGCG-1	Upper Layer
ATTCAACCAGTCTAAT-1	Subplate
ATTACTGAGGGTGAGT-1	Upper Layer
ATTCATGAGGTCCAAT-1	V-SVZ
ATTCCTCCAATTGAGA-1	Upper Layer
ATGTAAGCAGTAATAG-1	Upper Layer
ATTAACCCATTATGAC-1	Deeper Layer
ATTACCCGTATCTGGA-1	Deeper Layer
ATTCCTAGTAAGCACC-1	Upper Layer
ATTCATGAGTTAGTTG-1	Deeper Layer
ATGTCAATCAGCATTA-1	V-SVZ
ATTGACTCATCGCTTT-1	Deeper Layer
ATGTTTGAGGGTGGAT-1	RG, Astro, OPC
ATGTCAATCGGCCATA-1	Ependymal cells
ATTAGTCCATGAATAG-1	Upper Layer
ATTAGGTGTCCGTGAG-1	Interneurons1
ATTGAAGCAGTTGCGT-1	Ependymal cells
ATTCCTCCACTAGCGT-1	V-SVZ
ATTAGTCCACAACAGG-1	Interneurons1
ATTCCTAGTATTTGGG-1	V-SVZ
ATTACGTCATTTAAGC-1	Interneurons1
ATTACGTCAAGACTCC-1	RG, Astro, OPC
ATTGCGCCAAACGGGC-1	Upper Layer
ATTGCGCCATCAATCG-1	Upper Layer
ATTCGTTTCCAATTAG-1	Upper Layer
ATTACCGCAGGCCAAA-1	RG, Astro, OPC
ATGTCAATCATTATGG-1	V-SVZ
ATTCCTAGTTAATGCG-1	Interneurons1
ATTAGTCCAAGCCAGA-1	Deeper Layer
ATTCCTCCAAGGAATC-1	RG, Astro, OPC
ATGTCATCATAGGCGA-1	Cajal-Retzius
ATGTCCACATAGCGAG-1	Upper Layer
ATTACTGAGTGGCGGA-1	V-SVZ
ATTGTCCGTCTTTGAC-1	Deeper Layer
ATTCCTAGTGTCCTGC-1	Subplate
ATGTTGTCACCACAAC-1	Deeper Layer
ATTGCACAGTGGACAA-1	Interneurons1
ATTGACTCACTGACTA-1	Upper Layer
ATTACCCGTGAAGCCT-1	Deeper Layer
ATTAGTCCAAACATAG-1	Interneurons2
ATGTCATCATCTTGAG-1	RG, Astro, OPC
ATTGCGCCATCCATCT-1	Interneurons2
ATTGGTTCATAGGCGA-1	Interneurons2
ATTGAAGCAATATAGG-1	V-SVZ
ATTCGTTTCACGCCAA-1	Deeper Layer
ATTACCCGTGCATTAG-1	Deeper Layer
ATTATCCTCATGCTAA-1	Upper Layer
CAAAGTGAGGAGGTTA-1	V-SVZ
CAATAGCTCACATTGA-1	RG, Astro, OPC
CAAGCTAGTGACCTGG-1	Upper Layer
CAAGTAACACAACAGG-1	Upper Layer
CAATCCTGTAGTAAGA-1	V-SVZ
CAAACGCGTGTTGCTT-1	Interneurons1
CAACAGGCATAATTGC-1	RG, Astro, OPC
CAACTAGGTAAGTCGC-1	Deeper Layer
CAACCCGCATCTAGCA-1	Upper Layer
CAAATCATCCTAAGAC-1	Interneurons1
CAAACTGGTGTTAAAC-1	Cajal-Retzius
ATTTGTGAGCTTATGA-1	Interneurons2
CAAATCATCTTTAAGG-1	Interneurons2
CAAAGCGCAAGCGAGC-1	Deeper Layer
ATTTAGGTCACTCAAA-1	Deeper Layer
ATTGTGATCGATATTG-1	RG, Astro, OPC
CAAGTAACAAGATTCT-1	V-SVZ
CAAACACTCCGCCTAT-1	Deeper Layer
CAAGGGAGTTTGCGCC-1	Upper Layer
CAATAGCTCGCTAGAT-1	Upper Layer
CAAACATGTAGCCTAA-1	V-SVZ
ATTGTGATCCTGATTT-1	RG, Astro, OPC
CAAGGTTTCTTTGAGA-1	Deeper Layer
ATTTGCAAGCATTATG-1	Interneurons2
CAACTAGGTGGTGAGA-1	Upper Layer
CAAACATGTTTAACGG-1	Upper Layer
CAAGCTAGTCCTTCTC-1	Interneurons1
CAACAGGCATTTAAGC-1	Deeper Layer
CAAGAACCAAACTGCC-1	Deeper Layer
CAAGTTATCCACCTGT-1	V-SVZ
CAAAGGATCGGTTTGG-1	V-SVZ
CAAACAACACCCTCAC-1	Upper Layer
CAACAATGTGTTGCTT-1	V-SVZ
CAACCCTTCGGTTCCT-1	Interneurons2
CAAACTGGTAACAGGG-1	Deeper Layer
CAAACCGTCATTACTC-1	Upper Layer
CAATAAGCATTAGCCA-1	V-SVZ
CAAACAACATTGTGCA-1	V-SVZ
CAACTAGGTGATCAGC-1	V-SVZ
CAAATCATCGCTATAA-1	Subplate
CAAGCTAGTTCCTGTG-1	V-SVZ
CAAAGTGAGGAGCATA-1	Subplate
CAAACGCGTGACATAT-1	Subplate
CAAACACTCACTTCAT-1	Upper Layer
CAAGGTTTCCGCCTCA-1	Interneurons1
CAAGGTAAGATTGAGG-1	V-SVZ
CAAACCGTCTGTGCCT-1	Cajal-Retzius
ATTTGCAAGTAGCCAT-1	Interneurons3
CAAAGGATCATTATGG-1	Upper Layer
CAATAGCTCTTTAAGG-1	RG, Astro, OPC
CAAACATGTTTGGGCG-1	Deeper Layer
CAAGCTAGTACGCGCA-1	RG, Astro, OPC
CAAGTTATCGGTCAGC-1	Upper Layer
CAACAATGTACTGATG-1	V-SVZ
CAAGGTAAGTGAGGTA-1	Upper Layer
CAAGGTTTCCATTACT-1	Interneurons1
CAAGGTAAGAGAAGGG-1	V-SVZ
CAAAGGATCATGCCTC-1	Upper Layer
CAATAAGCACTGACCG-1	Upper Layer
CAACCCGCATAGCAGG-1	Upper Layer
CAAACATGTCTATCGT-1	Interneurons1
ATTTGCGCATGTCGCG-1	Interneurons1
CAAACATGTCACACCC-1	Upper Layer
ATTTAGGTCGCAACAT-1	Deeper Layer
CAAACTGGTGATGAGG-1	Upper Layer
CAAGGGAGTTACGCGG-1	Upper Layer
CAATCCCTCCTAAGTA-1	RG, Astro, OPC
CAAAGCGCATTAAACC-1	V-SVZ
CAAACATGTTGGTTGA-1	Upper Layer
CAAAGTGAGTTAGGCT-1	RG, Astro, OPC
ATTTGCAAGGAGGGTT-1	RG, Astro, OPC
ATTGTGATCTAAGTCA-1	Upper Layer
CAACCCGCATGGCCTG-1	V-SVZ
CAACCCTTCAGGATGA-1	Upper Layer
CAAACTGGTGCAATAT-1	Deeper Layer
CAAGGCTGTTTAAAGC-1	Deeper Layer
CAATCCCTCCGCCTCA-1	Upper Layer
CAACTAGGTCAAGTAT-1	Upper Layer
CAAGTGAAGGCCTTAG-1	Deeper Layer
CAAGGCTGTCCAAATG-1	V-SVZ
ATTTGCAAGGTTAGCT-1	RG, Astro, OPC
CAAATCATCATCCACC-1	RG, Astro, OPC
CAAGGTTTCCACAATA-1	V-SVZ
CAATATGTCGAAGTGA-1	V-SVZ
CAAGTAACATAAGCAA-1	Deeper Layer
CAAACATGTCGTAATG-1	Interneurons1
ATTTGTGAGGAGGTTA-1	Upper Layer
CAACCCTTCTCAATAG-1	Deeper Layer
ATTTAGGTCTCCATGC-1	Upper Layer
CAAGTGAAGGCAGGTG-1	Interneurons2
ATTGTGATCATGCTTT-1	Upper Layer
CAATGCCCATTGTTGG-1	Deeper Layer
CAATCTAAGGTGTTAC-1	Subplate
CAGGACCTCCTAATGA-1	Upper Layer
CACTTTGTCGCTTGCT-1	Deeper Layer
CACTTAAAGGATTGAG-1	Upper Layer
CAATGACTCCCTCGCA-1	Upper Layer
CAGGCTGGTTGCAGTA-1	V-SVZ
CACGCAATCTTGTTCG-1	Interneurons3
CACTTAAAGCGCTAAT-1	V-SVZ
CAATGTGGTATTACCC-1	Upper Layer
CACAAGCGTCTTGCAT-1	Deeper Layer
CAGCCTAAGGGTGAGT-1	Interneurons2
CACCTCAGTTAGGATT-1	Interneurons2
CAGCCTAAGGCCCAGT-1	Deeper Layer
CAATGTCAGTGAAGTG-1	Deeper Layer
CAGGATGCATTAAGTC-1	Interneurons1
CACAAGCGTTACTTCA-1	Upper Layer
CACAGGCTCTCGCCTG-1	V-SVZ
CACAATATCTAACCAA-1	Upper Layer
CAATCTAAGTAATCCA-1	Upper Layer
CACCTCAGTGCTAGCG-1	RG, Astro, OPC
CAGCATGTCACAGGAA-1	Upper Layer
CACAATATCTAATCTC-1	Interneurons1
CACTAGCCACCATATG-1	V-SVZ
CAGGACCTCTAAGGTC-1	Deeper Layer
CAGCATGTCCCATAAA-1	Interneurons1
CACTTAAAGTCATTAG-1	Deeper Layer
CAGCCTAAGCGCAATT-1	V-SVZ
CAATGAACATTGCAGC-1	RG, Astro, OPC
CAGCATGTCGGTTTGG-1	Subplate
CAGGACACAGTAGGTG-1	Interneurons1
CACAATATCTAGCTTT-1	IPC
CAGCCAATCCCTGTTA-1	Deeper Layer
CAATGCCCAAATGCCC-1	RG, Astro, OPC
CACATAATCAAAGGCA-1	IPC
CACCTGTTCAGCAAAG-1	Deeper Layer
CAGCATTAGTAACGAG-1	V-SVZ
CAGGACCTCAATCATG-1	Upper Layer
CAGAACCGTTGAGCCG-1	IPC
CAGCTAAGTGTTGTAG-1	V-SVZ
CAATGCCCAACACCTA-1	RG, Astro, OPC
CAGGACCTCAAGTGAG-1	Interneurons2
CAATGTCAGCTCGCTT-1	Deeper Layer
CAGGCTGGTTCACTGT-1	Upper Layer
CACATACAGGCCGGAA-1	RG, Astro, OPC
CACTTTGTCCCGTTAC-1	Upper Layer
CACGCAATCAAGTGAG-1	Ependymal cells
CACATAATCTTGCAAA-1	V-SVZ
CACCTCAGTTAGAGCC-1	Deeper Layer
CAGCATTAGGCTGTGC-1	Deeper Layer
CAGGACCTCGGGACTC-1	Interneurons1
CACTAAGGTTGTAAAC-1	Upper Layer
CACCTGTTCTTTAAGG-1	V-SVZ
CACCGGTAGGACGTAA-1	Upper Layer
CAATCTAAGGAATAAC-1	RG, Astro, OPC
CACAATATCGATCAGT-1	RG, Astro, OPC
CAGGCTATCGCTAGCA-1	Interneurons2
CACGCAATCTCGCCTG-1	Deeper Layer
CACTTTGTCCTTCGTA-1	RG, Astro, OPC
CAATCTAAGGATAAAC-1	IPC
CACCTGTTCCTGTTCA-1	Upper Layer
CAGGACACATTGCGTA-1	Interneurons1
CAGCAAGCAGGATTAA-1	RG, Astro, OPC
CAATGACTCCTGATGG-1	Upper Layer
CACCGGTAGGACTAAG-1	Deeper Layer
CAGCTAAGTTGTAAAC-1	V-SVZ
CAGAATCTCGCAACAT-1	Deeper Layer
CACCTCAGTGAATCGC-1	Upper Layer
CAGGATGCATTGTGTG-1	Interneurons1
CACATTAAGGCATGAA-1	Deeper Layer
CACAAGCGTTTAGTCC-1	Upper Layer
CAATCGCCAGGCGAGT-1	V-SVZ
CACTAGCCATCAATCG-1	RG, Astro, OPC
CAATCTAAGCATTATG-1	Interneurons1
CACAATATCCTGGTGA-1	Subplate
CACAGGCTCTGGCTTC-1	V-SVZ
CACTGACCAACACCTA-1	V-SVZ
CAGGCTATCTGTGAGT-1	Interneurons3
CAGCTAAGTTAGGTTG-1	Interneurons2
CAGATTCAGCGAGCGA-1	Deeper Layer
CAGGACCTCCACCTGT-1	Interneurons2
CAATCTAAGTAGCTTA-1	Upper Layer
CAATCTAAGTTATCTC-1	RG, Astro, OPC
CAATGCCCAACTCGCG-1	Interneurons3
CAGCATGTCGTTAACA-1	IPC
CATAATCCACTGACCG-1	Deeper Layer
CATCACACAACAGGTG-1	Deeper Layer
CAGTATGGTGCTCCAC-1	Deeper Layer
CATAAGCTCGTCAAGT-1	Deeper Layer
CATCCTGGTAGTTACG-1	Upper Layer
CATGGATTCGTCCTTA-1	V-SVZ
CATCAATCACCTAATG-1	Upper Layer
CAGGTCCAGTTAGAGG-1	Upper Layer
CATGGCGGTATCTGGA-1	V-SVZ
CAGGTTTAGCAACATC-1	Deeper Layer
CAGGTTTAGCGTGCGT-1	Upper Layer
CATCCCAGTTAGGTTG-1	Ependymal cells
CATCGCTTCGGTACGC-1	Upper Layer
CATGCGGGTGCACGCA-1	RG, Astro, OPC
CATCCTGGTGGATGTC-1	IPC
CATAGTCAGGAACCGG-1	RG, Astro, OPC
CATTCATTCACCTGCT-1	Upper Layer
CATAGCTAGGTGAAGC-1	Deeper Layer
CATAGCTAGTTCCCAC-1	IPC
CATCACACAATTAGCT-1	Upper Layer
CATAAGCTCTTGAGGT-1	Upper Layer
CATAATCCACAACAAA-1	RG, Astro, OPC
CATATCGCAATTATGC-1	RG, Astro, OPC
CATTATCTCAATGTGC-1	RG, Astro, OPC
CAGGTGGAGACAACGA-1	V-SVZ
CATAAGCTCTAAGTCA-1	Ependymal cells
CATCATGCACGGTTTA-1	Ependymal cells
CATTATGAGTTTCCTG-1	V-SVZ
CATAGACTCTTTGAGA-1	Upper Layer
CATATCGCATTAGGTT-1	V-SVZ
CATAATCCATAGTCAT-1	RG, Astro, OPC
CATCCCAGTAACCACA-1	V-SVZ
CATCAATCATAATCGT-1	Subplate
CATCCTTCAACTCGCG-1	Cajal-Retzius
CATAGGTTCAGGTTTA-1	Upper Layer
CATAGTCAGCTTTGGG-1	RG, Astro, OPC
CAGGTCCAGGCTGGCT-1	Interneurons2
CAGGTGGAGGGTCTAT-1	RG, Astro, OPC
CATAGGCGTTTATGGG-1	Upper Layer
CATTCATTCCTAAGGT-1	RG, Astro, OPC
CATGAGGCACCTACGG-1	Subplate
CAGGTTAGTGAACAAA-1	Upper Layer
CATCCTCAGCTATATG-1	Upper Layer
CATATCGCACCAGCAT-1	V-SVZ
CATCAATCAGGCTGTT-1	Upper Layer
CATCCTGGTTGCAGTA-1	V-SVZ
CAGGGTGAGACTAAGG-1	V-SVZ
CATAATGTCAGGTTTA-1	Upper Layer
CATCAGCCATGATTGT-1	Interneurons3
CAGGGTGAGTGAACGA-1	Upper Layer
CATCATGCACACCAAC-1	RG, Astro, OPC
CATCCTTCATTATGCG-1	IPC
CATGCAAGTGCTTAGA-1	RG, Astro, OPC
CATGCAAGTTGGATAT-1	Interneurons1
CATCCTTCATTAGGTT-1	Interneurons1
CATCCCAGTTCCTGTG-1	Deeper Layer
CATAAGCTCAACCAAC-1	Interneurons2
CAGTATGGTAATGACT-1	Interneurons2
CAGGTCCAGGCGGGTA-1	V-SVZ
CATAGGTTCTCAATAG-1	RG, Astro, OPC
CATCAGCCATCAATCG-1	Ependymal cells
CATCCCAGTCGCAATA-1	Upper Layer
CATCATGCAACTGGGA-1	RG, Astro, OPC
CAGGTGGAGCTAAAGG-1	Interneurons1
CATGGCGGTGAGCGAA-1	Deeper Layer
CAGGCTGGTTTGGGTA-1	Deeper Layer
CAGGTCCAGCGCTCAA-1	V-SVZ
CAGGTCCAGTCATTTC-1	Deeper Layer
CATAATGTCCGTCCAT-1	Ependymal cells
CAGGTTTAGCCTGAGC-1	RG, Astro, OPC
CATCCCAGTCCTTAGT-1	IPC
CATAGCTAGCCAGTAT-1	Deeper Layer
CATGGATTCCTACCTA-1	Upper Layer
CAGGTTTAGGTTTGCG-1	Subplate
CATGAGGCACATAGCC-1	Interneurons2
CAGGGTGAGCTATGAC-1	Deeper Layer
CATGCAAGTTTATTCG-1	Ependymal cells
CATATCGCATTGTCAG-1	V-SVZ
CATAGACTCAACCAAC-1	V-SVZ
CATGAGGCAAGGACCA-1	V-SVZ
CATAGACTCGTGCTTC-1	Ependymal cells
CATGCAAGTGGGTACT-1	Interneurons1
CATCGCTTCGGTAACT-1	IPC
CATCATGCAGTCTAGC-1	Upper Layer
CAGGTCCAGAAGCTAG-1	V-SVZ
CATCCTTCAAGGTGGC-1	Deeper Layer
CATAACGGTGTTTGCT-1	Ependymal cells
CATGCAAGTAAACAAG-1	IPC
CATTCATTCATGAGCT-1	Upper Layer
CATGCATAGGTCGATT-1	Ependymal cells
CATAACGGTAACGAGG-1	V-SVZ
CATTATCTCAAAGGCA-1	Deeper Layer
CCAAGTTAGGCGCTAC-1	Subplate
CCATAGCCAATTGCGC-1	V-SVZ
CCAAGGCTCGGTCAGC-1	V-SVZ
CCACAGGGTTACATCC-1	V-SVZ
CCAGGATGTAGCTAAT-1	Deeper Layer
CCATAATCATTAGCCA-1	Interneurons2
CCAACATAGGCCCAGT-1	Subplate
CCAGGAACATGCTATG-1	RG, Astro, OPC
CCATAGCCATGTCGCG-1	Deeper Layer
CATTGTAAGGGTCCAC-1	RG, Astro, OPC
CCAAGGCTCCTTGAGG-1	Upper Layer
CCACAATAGGAAGCTA-1	Deeper Layer
CATTCATTCTTGCTAT-1	V-SVZ
CCCAGCACATGAATAG-1	Ependymal cells
CCAGGAACACTGACCG-1	Upper Layer
CCCAAATAGCCGCAGT-1	Upper Layer
CCAAACCCAGGCGATA-1	Ependymal cells
CCAGACTCAGCTCAAC-1	RG, Astro, OPC
CCATCACTCATTGTCT-1	Upper Layer
CCAGTTTGTCACGGAT-1	Interneurons2
CCATTATTCCTGATTT-1	Upper Layer
CCACAGGGTGATTACG-1	RG, Astro, OPC
CCATAGCCAATAACCT-1	V-SVZ
CCAACCAAGCGAGCGA-1	Deeper Layer
CCAGCTAAGGATGATG-1	Upper Layer
CCAGCTGCATAGACCC-1	IPC
CCAGTTTGTAGCTGGT-1	V-SVZ
CCATCACTCCACAATA-1	Upper Layer
CATTGTAAGCTAAAGG-1	V-SVZ
CATTGTGCATAAAGCA-1	Ependymal cells
CCAGACTCACCTACGG-1	V-SVZ
CCATAGCCAGCAACAG-1	V-SVZ
CATTTGTTCGTGCCTT-1	Interneurons3
CCCAAACCAAGTCGCT-1	V-SVZ
CCCAAACCAGTAAGTA-1	RG, Astro, OPC
CCAGACTCACAGAAAC-1	V-SVZ
CCATAAATCGTCAAGT-1	Deeper Layer
CCAACATAGCCTGATG-1	Upper Layer
CATTCCTCACCTGGTG-1	Upper Layer
CCCAGCACATTGCGTA-1	RG, Astro, OPC
CCATATTTCACAGGAA-1	RG, Astro, OPC
CATTTGTTCAGCTAAC-1	Deeper Layer
CCACAGGGTAGCCTAA-1	Ependymal cells
CCCAGCACACCTGTAA-1	V-SVZ
CCAGCTGCACCCACAG-1	V-SVZ
CCAGGAACACCGTTCC-1	V-SVZ
CCAACCCGTTGCTTCG-1	Deeper Layer
CCAATATCAGGCGATA-1	Upper Layer
CCATAATCAATTAGGA-1	V-SVZ
CATTCCTCATAATTGC-1	Subplate
CCAGTTTGTGTTGCTT-1	V-SVZ
CCAGCCTGTAGACAAA-1	Interneurons1
CCAAATCAGTGACCTG-1	Deeper Layer
CCAATATCACATTAAC-1	Deeper Layer
CCCAAACCATTTGCTC-1	Upper Layer
CCAACCCGTGACATGC-1	Upper Layer
CCACTTGGTTACAACG-1	Upper Layer
CCAGCTAAGTTAGAGG-1	Interneurons2
CCAGCCTGTTCACCAT-1	Interneurons2
CCAACCCGTAGCTGGT-1	Upper Layer
CCATAATCAGTAGGTG-1	Deeper Layer
CCAGGATGTTTGAGCA-1	Interneurons3
CATTGCGAGCAACATC-1	Ependymal cells
CCATCATGTTGGCGTG-1	V-SVZ
CCATAGCCACTGACTA-1	Upper Layer
CCACTTGGTTTAGTCC-1	IPC
CCATTATTCCTTGCAC-1	RG, Astro, OPC
CCAGCTGCATTAAGTC-1	V-SVZ
CCCAATTGTCATTACC-1	RG, Astro, OPC
CCCAGCACAATCCCTT-1	Interneurons1
CCCAAACCATAGCGAG-1	Upper Layer
CCAATATCAAGTGTTT-1	IPC
CCACAATAGCCTGATG-1	Upper Layer
CCCAAATAGGAAGTAT-1	RG, Astro, OPC
CCATATTTCACACAGT-1	Interneurons2
CCATTGTGTCACGGAT-1	V-SVZ
CCAAGTTAGTCACCTC-1	Interneurons1
CATTCCTCAGGTTATT-1	Deeper Layer
CCATAAATCCGGAACC-1	IPC
CCAAGTTAGCCTAATA-1	Upper Layer
CCATCATGTTACCTGT-1	Ependymal cells
CATTGTGCAGTCTATG-1	Deeper Layer
CCAGCTAAGTCAATCA-1	Ependymal cells
CCAAATCAGCCACATG-1	Deeper Layer
CCAAACTAGACAGGCG-1	RG, Astro, OPC
CCAACCCGTTGTTGCT-1	Interneurons1
CCAAGTTAGGGACCTC-1	V-SVZ
CCATAATCACAACAAA-1	IPC
CCATAAGGTTAGAGCC-1	V-SVZ
CCAAACCCATAATTGC-1	RG, Astro, OPC
CATTCCTCATACCCGG-1	RG, Astro, OPC
CATTGCGAGTACTGGT-1	Upper Layer
CCGCTAGCAAGGCCAA-1	Upper Layer
CCTAAAGGTCCGTAGG-1	Upper Layer
CCTAAATCAATAACGA-1	Upper Layer
CCTAAGTAGAGCAAGC-1	Subplate
CCGCAAGGTTGCAGTA-1	RG, Astro, OPC
CCGTGCTGTTAGCTGA-1	Upper Layer
CCTAAATCACGAATTT-1	Upper Layer
CCGCAAATCGTTTCCA-1	Deeper Layer
CCGATGCAGAGAAGGG-1	V-SVZ
CCCATAACAGGTTACC-1	V-SVZ
CCTAATCGTTAGGATT-1	Upper Layer
CCTAAGCCATTGTTGG-1	V-SVZ
CCTAAAGGTGACATGC-1	V-SVZ
CCCTAATGTAATGGCC-1	V-SVZ
CCGACAGGTGCTGTAA-1	Upper Layer
CCGTTAACACATACTG-1	Upper Layer
CCCGCAACACAGAACG-1	RG, Astro, OPC
CCTAAGCCAGTTGCGT-1	V-SVZ
CCCGCAACAGCTTAAT-1	Subplate
CCGCCAACATGTTTGG-1	V-SVZ
CCTAGTTGTTACGCGG-1	Interneurons1
CCTACTGGTTTCGCGC-1	Ependymal cells
CCGCACACAGGCCATT-1	Upper Layer
CCGTTAACAAAGGTAC-1	Interneurons2
CCTACTTCAGTAGGTG-1	Interneurons2
CCGCCAACACACCAAC-1	V-SVZ
CCGCTTAGTTTAACGG-1	Deeper Layer
CCCTCACCAAACTCAT-1	Interneurons2
CCTCAATGTTGGTTAG-1	Upper Layer
CCGTTAACAATCTCTC-1	Deeper Layer
CCCTCACCAGGATAAC-1	Deeper Layer
CCCTCATAGGTGAGAC-1	Upper Layer
CCTAAGGTCGCAAACT-1	Interneurons2
CCTATAGCATGCAACC-1	Interneurons2
CCCTCATAGTATTGCA-1	Upper Layer
CCGTTATGTTATGTGG-1	Ependymal cells
CCCGCAACACAATGTT-1	Interneurons2
CCGATGCAGTCTCACC-1	Interneurons1
CCGTTACTCTATCGCC-1	Upper Layer
CCTCAGTTCCCGCAAA-1	V-SVZ
CCGTTTGGTGTTGTGA-1	Subplate
CCCATAACAAGATTCT-1	Interneurons1
CCGCTTAGTTGGATAT-1	RG, Astro, OPC
CCCGCAACAAGCTTTG-1	Interneurons1
CCGGTAGGTTCCTGAT-1	V-SVZ
CCCTGGACAAACCTTG-1	Upper Layer
CCGATGCAGTAAGTCC-1	Deeper Layer
CCCTGGACATCACAGC-1	Ependymal cells
CCTATTTAGGAGGGTT-1	Subplate
CCGGTTAAGGCCCAGT-1	Interneurons2
CCTAAGTAGGTACCGC-1	IPC
CCGTTTGGTCGCATAA-1	Deeper Layer
CCGCTTAGTTAGCATG-1	RG, Astro, OPC
CCTCAAACAGCAATAA-1	RG, Astro, OPC
CCTATTGTCAATACGC-1	V-SVZ
CCTAATAAGAGGATAT-1	Upper Layer
CCGGTTAAGGCTCATG-1	Upper Layer
CCGTTTGGTCCTTAGT-1	Interneurons3
CCCTAATGTACTTCAC-1	Deeper Layer
CCTATTGTCTTAGGGT-1	Subplate
CCCGTAAAGATGGACA-1	Deeper Layer
CCCTCATAGTGAGAGC-1	IPC
CCCTGTTAGTAAAGGT-1	Upper Layer
CCCTCATAGCTTGCTC-1	Deeper Layer
CCGCCAACATGTTGGC-1	Upper Layer
CCGCTAAAGACACTTA-1	Upper Layer
CCTACTTCACCTACTT-1	Subplate
CCTATTGTCTAGCGTG-1	Upper Layer
CCTACTTCAGAGGGAG-1	Deeper Layer
CCCGCAACACCTATAG-1	Interneurons2
CCGGTTAAGCGTGCAC-1	V-SVZ
CCGGTAGGTGTGCAAC-1	V-SVZ
CCCGCTTCAATAGTCT-1	IPC
CCGGTAGGTCAGGAAG-1	Subplate
CCTAAGGTCCGCCTCA-1	Upper Layer
CCTAATCGTTAAGCTG-1	Interneurons2
CCTACTGGTAGGATTT-1	V-SVZ
CCGCAAATCATTGCGG-1	RG, Astro, OPC
CCGCTAGCAAGGTCGA-1	Cajal-Retzius
CCTAAGTAGCGGATAA-1	V-SVZ
CCCTAATGTTACAAAC-1	Upper Layer
CCGCTAAAGGTGAAAT-1	Upper Layer
CCTAATAAGACAAACG-1	V-SVZ
CCGTTGCGTATGGTGC-1	Interneurons3
CCGATGCAGTAAGGGC-1	V-SVZ
CCTAAGCCACGCAACT-1	Interneurons1
CCCGTAAAGTTTAACG-1	V-SVZ
CCGCTAGCAATTAACC-1	V-SVZ
CCCGTTGTCCTTCTAG-1	Deeper Layer
CCTCAGTTCTTAGCCC-1	V-SVZ
CCTGTAACAGTTTCTC-1	RG, Astro, OPC
CCTTCGGTCTAATCCT-1	Upper Layer
CGAACCGGTGTTTGCT-1	Upper Layer
CGAAGCGAGTTTGAGC-1	V-SVZ
CCTGCTCCACATACTG-1	Deeper Layer
CCTTAGTGTGCGCATG-1	V-SVZ
CCTCCTCTCTGTGAGT-1	RG, Astro, OPC
CGAAATGAGGGATGAC-1	Interneurons1
CGAGGTGAGTCCTGAG-1	V-SVZ
CCTTATGTCAAAGGCA-1	Deeper Layer
CCTTACTCAGGTCCTG-1	RG, Astro, OPC
CGAAGCGAGCCTAATA-1	Deeper Layer
CGACCTGCATTCCTGT-1	Interneurons1
CCTTATGTCTTAGTGA-1	Upper Layer
CGAAATGAGGACGTAA-1	Upper Layer
CGAACAAAGCGCTCAA-1	Interneurons1
CGAGTCGGTTAGACCA-1	Ependymal cells
CGAACCGGTCACTCGC-1	IPC
CGACCTGCATACCCGG-1	RG, Astro, OPC
CCTTGCGTCGGTACGC-1	Upper Layer
CCTGTATGTCAAGACC-1	IPC
CCTTATGTCAGGGCCT-1	Upper Layer
CCTTAACGTCATTAGG-1	Upper Layer
CCTGCTCCAGGGAGGA-1	Upper Layer
CGACAAGCACTTAGGC-1	Interneurons1
CGAAATGAGCATGCAT-1	Deeper Layer
CGAATCTAGCGATAAG-1	Deeper Layer
CCTTGCGTCCTGGCTT-1	Upper Layer
CGAGGTGAGCTACTGG-1	Upper Layer
CCTTCGGTCCCGCATT-1	RG, Astro, OPC
CCTTCGTAGCAGCTCA-1	Ependymal cells
CGACTAAGTTAGTACG-1	V-SVZ
CGAAGAATCTAGCTAA-1	Deeper Layer
CGAGCGAAGTTAGAGG-1	RG, Astro, OPC
CGAACCGGTCGCGCAA-1	IPC
CGAGTCGGTTGACTTC-1	Deeper Layer
CCTGGATCAAGTGTCC-1	Ependymal cells
CGAGTCGGTTAGCGTA-1	Upper Layer
CCTGTTGGTTACAACG-1	V-SVZ
CGAGGTGAGTCATGCG-1	V-SVZ
CCTGCTCCAACTAGGG-1	Interneurons2
CCTGCTCCAAGCTTAT-1	Ependymal cells
CCTTGCGTCATTAGGC-1	Deeper Layer
CGAGGCAAGAGAGGCT-1	Upper Layer
CCTTCAGGTGTTTGCT-1	Upper Layer
CCTTATGTCATCGTTT-1	Upper Layer
CCTTAACGTATACTGG-1	Upper Layer
CGAAGAATCAGGTCCA-1	RG, Astro, OPC
CCTTAGTGTACAATGT-1	Interneurons1
CGAAGCCTCAGGGCCT-1	Interneurons2
CCTGGATCAGTTTGTG-1	V-SVZ
CGAGTCGGTAAGCTTG-1	Ependymal cells
CGATCCTTCTACCTGC-1	Interneurons3
CGAGCTGGTTATCCGT-1	V-SVZ
CCTGATGAGAACAAGT-1	Upper Layer
CCTGGATCACGCAACT-1	V-SVZ
CGACTAAGTCAAGTAT-1	Ependymal cells
CGACAAGCATAAGTCT-1	Deeper Layer
CCTGAATAGTAGAGGC-1	V-SVZ
CGAATCTAGGCTCATG-1	Upper Layer
CGAGGCAAGAGCCGCT-1	V-SVZ
CGAATCTAGCCAGTAT-1	V-SVZ
CGAAGCGAGGCAACAA-1	Upper Layer
CCTTCGTAGGCTTAAC-1	Subplate
CCTCCTGAGACAGGCG-1	Interneurons2
CGATCCTTCATGCGTG-1	Deeper Layer
CCTTGCGTCATGGTTA-1	Interneurons1
CCTTCGTAGCGATACT-1	V-SVZ
CCTGAATAGGTGAAGC-1	Deeper Layer
CGACCTGCACTAAGAA-1	Upper Layer
CCTCCTCTCGTTACAA-1	Upper Layer
CCTCAGTTCGAGCAAA-1	RG, Astro, OPC
CCTGTATGTAGCTGGT-1	Subplate
CGACCTGCACCTCACC-1	Upper Layer
CGATCCTTCATGCTAA-1	Interneurons2
CCTGACTTCAAACCTA-1	Interneurons1
CGACTAAGTCGTTATC-1	IPC
CGAGGAAGTAGCCTCC-1	Upper Layer
CCTTCAGGTTCGCGCT-1	Upper Layer
CGAAGGCCATGCTTAG-1	V-SVZ
CGAGGCAAGCTTATGA-1	Interneurons3
CGAATCTAGCTTACTT-1	Interneurons1
CCTTCGTAGTTAGCTA-1	Subplate
CGAAGCGAGGTTTGCG-1	V-SVZ
CCTGAATAGCACAGAA-1	Deeper Layer
CGACCTGCACTTCATC-1	Interneurons3
CGATGTCCAGGCCAAA-1	V-SVZ
CGAAGCCTCCTCATGC-1	RG, Astro, OPC
CCTGTATGTGACATAT-1	Deeper Layer
CGAGCGAAGTGGCGGA-1	V-SVZ
CGCCACACAACGTGCT-1	Ependymal cells
CGGAATCGTCATCATC-1	Upper Layer
CGCAAATTCACTCAAA-1	RG, Astro, OPC
CGATTCCTCGTGCTAG-1	Deeper Layer
CGCTAATAGGTTTACA-1	Interneurons1
CGCTTGCGTCATTGTC-1	RG, Astro, OPC
CGATGTCCAGTAGGAT-1	Deeper Layer
CGCAAATTCCTAGTCC-1	Deeper Layer
CGCACACAGGAGGTTA-1	RG, Astro, OPC
CGGATAAAGCGATAGA-1	Deeper Layer
CGCGATTCATCTTGAG-1	Upper Layer
CGCACACAGAGCAAGC-1	Upper Layer
CGGCAATGTGAAGCCT-1	Interneurons3
CGCATGATCATCCACC-1	Ependymal cells
CGGCAATGTCCGTAGG-1	Upper Layer
CGCACCACATAGCTGC-1	Ependymal cells
CGCAATAGTGGAAGGC-1	Interneurons1
CGCTCAGCAGGCTTCG-1	V-SVZ
CGCAATTAGGAGGGTT-1	V-SVZ
CGCATGATCTTGAGGT-1	Upper Layer
CGCGGATTCAAGTGAG-1	Interneurons1
CGCACCACAATTTGGT-1	Subplate
CGGCAATGTGAGCAAG-1	Upper Layer
CGCTCCATCTGGCAAT-1	Deeper Layer
CGCATTACATAGGCGA-1	Deeper Layer
CGATTCCTCTTGTCTG-1	Upper Layer
CGCTACTTCCAGGTTG-1	Ependymal cells
CGCATTACACAACAGG-1	Ependymal cells
CGATTCCTCATGGTTA-1	Upper Layer
CGCCACACAAGCGATG-1	Upper Layer
CGCACACAGCGCTAAT-1	V-SVZ
CGCTAACCATGTTGTG-1	RG, Astro, OPC
CGGATTAGTTGCGCGA-1	V-SVZ
CGATTATCATAAAGCA-1	V-SVZ
CGATTATCATTAAAGG-1	Interneurons2
CGCTACTTCGCGCTAA-1	Interneurons2
CGCACACAGCTATATG-1	V-SVZ
CGCTAATAGGTAAGGC-1	V-SVZ
CGCTCAGCAGGACCTT-1	V-SVZ
CGCAATAGTCATTAGG-1	IPC
CGCACCACATAGCAGG-1	Subplate
CGCATTACACTTGTTC-1	Interneurons1
CGCACAATCTTGGATA-1	Interneurons3
CGGAATCGTCTAGCTT-1	Interneurons1
CGCTCAGCATCCCTCA-1	Upper Layer
CGGATAAAGCAGGTTT-1	Interneurons2
CGCACACAGGTGAGAC-1	Upper Layer
CGCTTAACAATTGAAG-1	Upper Layer
CGATTATCATGGTTAT-1	Deeper Layer
CGCAATGTCCCGCCTA-1	Interneurons1
CGCACAATCAACCAAC-1	Interneurons3
CGCGATTCAATACTGT-1	V-SVZ
CGCTTGCGTCCGTGAG-1	IPC
CGATGTCCATGAATCT-1	Upper Layer
CGCTTACTCAATTGGC-1	Upper Layer
CGCATATAGCCTGATG-1	Ependymal cells
CGATTTGCATAATCGT-1	Upper Layer
CGCTAATAGTCATGCG-1	Deeper Layer
CGATTTGCAGTAAGTA-1	Cajal-Retzius
CGCTTACTCCACCTTA-1	Microglia
CGCAATTAGTTAGACC-1	Interneurons2
CGGAGCAAGTAATCCA-1	Upper Layer
CGCTTAACACTAAGTT-1	RG, Astro, OPC
CGCACACAGCACTAGT-1	RG, Astro, OPC
CGCAATAGTGGGTGAA-1	Interneurons2
CGCGGATTCCCTGGAA-1	V-SVZ
CGCTAATAGGTCGAGG-1	Upper Layer
CGCTGTGCAGCCAGAA-1	Interneurons1
CGCTTGCGTGACATAT-1	Deeper Layer
CGCAATTAGGTGCGGA-1	Deeper Layer
CGGAATCGTTGCCTCA-1	V-SVZ
CGATTTGCACGCAACT-1	Upper Layer
CGCTCCATCCGTGACA-1	Interneurons1
CGGAATCGTGTAACCA-1	V-SVZ
CGCAATTAGAAACTGG-1	Ependymal cells
CGCATGATCCCGAACA-1	RG, Astro, OPC
CGATTGAGTTGTTCAC-1	Upper Layer
CGGACAACAACTAGCC-1	Ependymal cells
CGATTGAGTGTAACCA-1	Upper Layer
CGCTATGAGGTGAGAC-1	Upper Layer
CGCCAAATCATGCTTT-1	IPC
CGCACACAGGTTTGCG-1	Deeper Layer
CGGCAATGTTAACGGC-1	V-SVZ
CGATTCCTCTCACACC-1	V-SVZ
CGGATAAAGAGGAAGG-1	RG, Astro, OPC
CGGATTAGTGCTAGCG-1	RG, Astro, OPC
CGCATTTGTTAGACCA-1	Upper Layer
CGCGATTCAGAGAGCC-1	V-SVZ
CGATTGAGTGTTAGCA-1	Deeper Layer
CGCCTGTGTAATGGCC-1	Upper Layer
CGCAATGTCATGCATA-1	Deeper Layer
CGCTCCATCTCCTCTT-1	V-SVZ
CGTCAATAGGAGCAAC-1	Deeper Layer
CGTAACTAGGATAAAC-1	Upper Layer
CGTGGTTCATGGCCTG-1	Deeper Layer
CGTAACTAGCATGTTA-1	RG, Astro, OPC
CGTTATCGTAACCAGC-1	Upper Layer
CGTGAGGAGGAGGTTA-1	RG, Astro, OPC
CGGGACAAGTTATCCT-1	Interneurons1
CGGTAACGTAGCAGCT-1	Deeper Layer
CGTAACCCAGTCTAGC-1	RG, Astro, OPC
CGGTTTGAGGCAATAG-1	RG, Astro, OPC
CGGCAATGTTAATCGG-1	Upper Layer
CGTCAATAGACCATAC-1	Upper Layer
CGTTAAATCCAGGTTG-1	Deeper Layer
CGGTTTCTCACAGCGC-1	Upper Layer
CGTGCTGCAGCGCTTG-1	V-SVZ
CGGTGAGAGGACAACA-1	V-SVZ
CGTAACCCAAATATCC-1	Ependymal cells
CGGTGAGAGTCTATGA-1	Upper Layer
CGTGGTTCAAGCTTTG-1	Interneurons1
CGTCCTAGTACGATTG-1	V-SVZ
CGGTTTGAGGTGCTGC-1	Subplate
CGTATTGCATTAAGCT-1	V-SVZ
CGTGCTGCAAAGCTAA-1	Deeper Layer
CGGTAACGTTTGCAGA-1	RG, Astro, OPC
CGGTTATAGAAGGTGC-1	V-SVZ
CGTTATTTCGAGGAGT-1	RG, Astro, OPC
CGGTTCCGTTAGTACG-1	Upper Layer
CGGTTTGAGTGATTCA-1	Interneurons2
CGGGTCTAGTTGGATC-1	IPC
CGTAACTAGGCGCTAC-1	RG, Astro, OPC
CGGGCTTAGCATTAGC-1	Interneurons2
CGGTTATAGCATGTTA-1	IPC
CGTTAACAGTAATCCA-1	RG, Astro, OPC
CGTATTGCATCTAGCA-1	Deeper Layer
CGTCAATAGCCTGACA-1	Upper Layer
CGGTTATAGCTAAGTC-1	IPC
CGTACGGGTTGGCGTG-1	RG, Astro, OPC
CGGTAACGTAACCAGC-1	Interneurons1
CGGGTCTAGTATTGGC-1	Upper Layer
CGTACGGGTCACGGAT-1	Subplate
CGTCCTAGTGTTAGCA-1	IPC
CGGTTATAGTGCACGC-1	Ependymal cells
CGTTATTTCCAGGTCA-1	Interneurons1
CGTAACCCATCGCTCC-1	Interneurons1
CGTTATTTCCTTAAGA-1	Interneurons3
CGTAGCGGTACTTAGG-1	RG, Astro, OPC
CGTGAGGAGGCGCATC-1	RG, Astro, OPC
CGGTTGGGTCACCAAA-1	Ependymal cells
CGTTATTTCCTTCAAT-1	Ependymal cells
CGGTTTCTCCCTCAAC-1	Upper Layer
CGTTATTTCTCACTAT-1	Deeper Layer
CGTATTGCAGTGAACG-1	V-SVZ
CGTGAGGAGTCACTAA-1	Upper Layer
CGGCTAATCATTATGG-1	Interneurons1
CGTAACTAGATGCCTG-1	Interneurons1
CGTCATTGTTAGAGGG-1	V-SVZ
CGTCCTAGTTTCCACG-1	Ependymal cells
CGTGTGTCATGTTGTG-1	V-SVZ
CGGTGAGAGTCATGCG-1	Upper Layer
CGTGTTACAATTGACT-1	Deeper Layer
CGTGTGTCAGCTCATA-1	Upper Layer
CGGGTATGTTTAACGG-1	Interneurons1
CGGCTCACAGAAATGC-1	Upper Layer
CGGTGAACAATAGCCC-1	Deeper Layer
CGTTATCGTTACATCC-1	Upper Layer
CGGTGAACATGAGCAG-1	IPC
CGGTAACGTAACGGGA-1	RG, Astro, OPC
CGTAGCGGTATTGGTG-1	V-SVZ
CGTGCTTTCCGCATGA-1	IPC
CGTAACTAGCAAGGAC-1	Upper Layer
CGGTAACGTTAGGTTG-1	Upper Layer
CGGTTTCTCCAATAGC-1	Upper Layer
CGGGCTTAGGCGCACT-1	Upper Layer
CGGTTTGAGGCATTGT-1	Interneurons1
CGTAATGGTGGTTCCC-1	Deeper Layer
CGTGACATCTAACCTT-1	Interneurons1
CGGGACAAGACTATTG-1	Deeper Layer
CGGTTATAGGTTTGCG-1	IPC
CGTACGGGTACGGTAC-1	Upper Layer
CGGTTATAGTTTGCGG-1	Upper Layer
CGTGAGGAGCACGTTG-1	Interneurons1
CGTAATGGTCAGGCCA-1	IPC
CGGTTTCTCAAACCTA-1	RG, Astro, OPC
CGGTAACGTCCGGTTC-1	V-SVZ
CGGCCATAGTTAGCCG-1	RG, Astro, OPC
CGTCAATAGGAATAAC-1	Upper Layer
CGTCATTGTGGACATC-1	Deeper Layer
CGTATTGCACAGCCTG-1	RG, Astro, OPC
CGTGCTGCAATCCTAG-1	RG, Astro, OPC
CGGTAACGTTCAAGCA-1	Deeper Layer
CGGTTCCGTTCACTGT-1	Upper Layer
CTATGACAGTTATGTG-1	Interneurons1
CTACGAAGTAGCTAGC-1	Upper Layer
CTAGTCGAGTTGGCCA-1	V-SVZ
CGTTGCAAGGGTTATC-1	RG, Astro, OPC
CTAGCTGAGCGAAGTA-1	Upper Layer
CTAAGGTTCACAGACT-1	RG, Astro, OPC
CTACCTCAGCAGCTAT-1	Interneurons2
CTAATGTCATTAGGTT-1	Subplate
CTAGGCGGTTACAAAC-1	Interneurons1
CTAAAGCTCGTTAACA-1	Upper Layer
CGTTTCTCAAACCCTA-1	RG, Astro, OPC
CTAAGGTTCGTACCGA-1	Interneurons1
CTAGTAGGTAATGGAA-1	V-SVZ
CTAACCCTCCTAATGA-1	IPC
CTAATGTCACCTACTT-1	Upper Layer
CTACCGGCAGCAAATA-1	Subplate
CTAGATTCAGCCTTGG-1	Subplate
CTAGCGGGTTATCCTA-1	Deeper Layer
CTAGTCGAGTAACGGA-1	Deeper Layer
CTAGTTGCATTGCGTA-1	V-SVZ
CTAATGTCACATAGCC-1	Interneurons2
CTACCTCAGGCCATCA-1	Interneurons2
CTAGATTCAGTTTCTC-1	Interneurons1
CTAATAGTCCAAGTTA-1	Ependymal cells
CTAGTGAGTTGGATAT-1	Deeper Layer
CTAACCCTCTTAGGAC-1	V-SVZ
CTAGCTGAGTCTGGGC-1	Cajal-Retzius
CTAGCGGGTAAGCTTG-1	Interneurons2
CTAGCTGAGTGAGGGT-1	Deeper Layer
CTAATCTTCTACCTGC-1	Interneurons1
CTAATCGCAGAAATTG-1	IPC
CTAACCTGTCTCACTG-1	V-SVZ
CGTTTGGAGCGAGCGA-1	Interneurons2
CGTTTGGAGGTATTGC-1	Interneurons1
CGTTTGGAGGCTACAT-1	RG, Astro, OPC
CTAGCTTGTGTTTGCT-1	V-SVZ
CGTTATTTCTGGTCCT-1	V-SVZ
CGTTGCGCACAGGGAC-1	Deeper Layer
CTAATGTCAGTAAGTA-1	Interneurons1
CTAAAGCTCAGTGAAG-1	Upper Layer
CTAGCTTGTCAAGTAT-1	RG, Astro, OPC
CTATGATCAAAGGTAC-1	Interneurons2
CGTTTGGAGGATGATG-1	Ependymal cells
CGTTTCTCAGCCTGCA-1	Upper Layer
CTACCGGCAACCTGGT-1	Upper Layer
CTACCTCAGCACAGAA-1	Upper Layer
CTAGGCGGTGAGCGAA-1	Interneurons3
CTATGAGGTTGCACGG-1	Upper Layer
CTAGGCGGTAATAACC-1	Subplate
CTAACCACATAAACCT-1	Subplate
CTACTTAGTTAGCTGA-1	V-SVZ
CTACCGGCATCATGGC-1	V-SVZ
CTACAACAGATGGAGC-1	Deeper Layer
CTATAACCAACACCTA-1	Deeper Layer
CTATGATCACCAAAGG-1	RG, Astro, OPC
CTAAGGTTCTTTGACT-1	RG, Astro, OPC
CGTTATTTCTTTAGGA-1	Ependymal cells
CTAATGTCATTGTGAT-1	Deeper Layer
CTACCTCAGGTGCGGA-1	Deeper Layer
CTAGATTCATGGTTAT-1	Deeper Layer
CGTTGCAAGGCCTTAG-1	V-SVZ
CTAATCGCAGTCTAAT-1	Interneurons1
CTATGATCATACTCCT-1	RG, Astro, OPC
CTATGAGGTGTTGCAA-1	Subplate
CTAATGTCAGCATGTC-1	Upper Layer
CTAACCACATTAAGTC-1	Deeper Layer
CTAATTGAGGACGTAA-1	V-SVZ
CGTTGCAAGGGATGCG-1	Deeper Layer
CGTTTGGAGTAGGATG-1	Deeper Layer
CTATGACAGCGGTTAT-1	Deeper Layer
CTAATGTCACAAAGGT-1	Upper Layer
CTACCGGCATGTTGGC-1	V-SVZ
CTAACCCTCTAAGTCA-1	V-SVZ
CTAATCGCACCCACCT-1	Interneurons2
CGTTGCAAGGACCTGC-1	Upper Layer
CTACCTCAGTGACCTG-1	IPC
CGTTTCTCACTAGCGT-1	RG, Astro, OPC
CTAAGTCAGCCACAAT-1	Upper Layer
CTACCTCAGTTTCCGC-1	Upper Layer
CTATGACAGTCCTTCA-1	Deeper Layer
CGTTTCTCACAACCTA-1	Upper Layer
CTAATGTCACTGACTA-1	V-SVZ
CTACCTCAGGCGGGTA-1	V-SVZ
CTAAGGTTCTATCGCC-1	RG, Astro, OPC
CTATAACCAGAGGCTA-1	Interneurons2
CTAGTAATCCTTAGTT-1	Deeper Layer
CGTTTGGAGGACCGCT-1	RG, Astro, OPC
CGTTTGTGTGCTTAGA-1	Interneurons3
CTCAATAAGCTTTGTT-1	RG, Astro, OPC
CTCTAGCTCGCACAAT-1	Interneurons1
CTCCAAACAAGGTCGA-1	RG, Astro, OPC
CTCATCATCATTATGG-1	IPC
CTGAAACTCCGTTAAA-1	RG, Astro, OPC
CTCTAGCTCCTTTACG-1	IPC
CTCCAACTCCTGATGG-1	Upper Layer
CTCCAACTCACGCCAA-1	RG, Astro, OPC
CTCCAAACAGAGGGAG-1	Ependymal cells
CTATTCAGTCAAAGGG-1	RG, Astro, OPC
CTCCATCAGTAAAGGT-1	Upper Layer
CTGAAACTCACGAATC-1	Interneurons2
CTCGCTCCAATCGCAC-1	RG, Astro, OPC
CTCATTAGTCCGGTTC-1	Deeper Layer
CTCTGTTCAGGCGAGT-1	V-SVZ
CTGATCACACTTAACG-1	Upper Layer
CTGACATAGTTATGTG-1	Deeper Layer
CTCAATAAGGCCTAAT-1	Upper Layer
CTGACCAAGGCTTAGT-1	Subplate
CTCACAACACCAGGTT-1	V-SVZ
CTATTCAGTAGCTGCG-1	Interneurons2
CTCATTAGTTATGTGG-1	Deeper Layer
CTCACAACACAGGAAT-1	Ependymal cells
CTCCTGAGTCTTGCTG-1	Upper Layer
CTCGACAAGGAGTCGG-1	Upper Layer
CTCTTGATCGAGGAAC-1	IPC
CTCTAAGCAAGGCCAA-1	Upper Layer
CTCCAACTCGGTTACG-1	V-SVZ
CTGACCAAGCTCCTTA-1	Deeper Layer
CTCACAACATTGCGTA-1	Interneurons1
CTCGACAAGTAAGAAC-1	Deeper Layer
CTCTCACAGCGCTAAT-1	Deeper Layer
CTGATCACACGGTTTA-1	V-SVZ
CTATGTTTCGGCTAGC-1	Ependymal cells
CTATGGCCAGGATTAA-1	Interneurons1
CTGACCAAGGAGCATA-1	Interneurons1
CTGACCAAGCATGGTT-1	Upper Layer
CTCCCTGAGCTAAAGG-1	Deeper Layer
CTCATGACACAGACTC-1	Upper Layer
CTCGCTAGTCGTTATC-1	Upper Layer
CTCCAACTCCAATTAG-1	V-SVZ
CTATTCAGTACCGTTT-1	V-SVZ
CTGAAACTCGCTATGG-1	V-SVZ
CTGAATATCACTTCAT-1	RG, Astro, OPC
CTCTAGCTCTTTAAGG-1	Upper Layer
CTATGTTTCAATTACG-1	RG, Astro, OPC
CTATGTTTCGAAGTGA-1	RG, Astro, OPC
CTCCAAACATGAATCT-1	V-SVZ
CTATTGAAGTTATCCT-1	Interneurons2
CTCAATAAGCTAAGTC-1	RG, Astro, OPC
CTGATCACAAATACCT-1	Deeper Layer
CTCATGCTCTCATCAT-1	Interneurons1
CTATGATCATGAATCT-1	Deeper Layer
CTCATGCTCTGCAAAC-1	Upper Layer
CTCTTGATCATAACCA-1	Deeper Layer
CTATTACTCCAATTAG-1	V-SVZ
CTCCAACTCGAGCAAA-1	Upper Layer
CTCCTCACAGTAATAG-1	V-SVZ
CTGACCAAGCTGTCAG-1	Upper Layer
CTCACTCAGCTACTGG-1	Interneurons3
CTCGCTAGTTTAGTCC-1	Interneurons2
CTCTAGCTCATGTTTC-1	Deeper Layer
CTCAGGATCACTAGGT-1	Interneurons2
CTATTACTCGGCCATA-1	V-SVZ
CTGAATATCACCGGTA-1	Ependymal cells
CTGACATAGCTATTAG-1	Upper Layer
CTCACACTCGGTTAGT-1	Deeper Layer
CTCTAAGCATCAGCAC-1	V-SVZ
CTCGCTAGTTTGGGTA-1	Interneurons2
CTGACATAGGAAACTG-1	Upper Layer
CTCCAACTCCCTCAAC-1	V-SVZ
CTCCTCACAGAATGAC-1	Ependymal cells
CTCCTCACAGAAACGT-1	Interneurons2
CTCCAAACAAACAACA-1	Interneurons3
CTATTGAAGTTATTCC-1	Deeper Layer
CTCCGGACAGCAGGTA-1	RG, Astro, OPC
CTCCGGACAATCCTAG-1	IPC
CTCCGGACACTTACAG-1	IPC
CTGAATATCATTCATC-1	V-SVZ
CTCACAACACCAACCG-1	Upper Layer
CTCATTTAGTTCCTCA-1	RG, Astro, OPC
CTCATTAGTATTTGCC-1	Upper Layer
CTCCATCAGTCAGTAC-1	Upper Layer
CTCCGTCCACACCAAC-1	Upper Layer
CTCATTTAGCAGGTTT-1	V-SVZ
CTCAATAAGAATGACG-1	Interneurons2
CTCCTGAGTCGTTATC-1	Ependymal cells
CTGAATATCGGCTATG-1	Interneurons1
CTTAAGGGTTAAGCTG-1	V-SVZ
CTTCATCCATTAAACC-1	V-SVZ
CTTCACTCAAGCGATG-1	Upper Layer
CTTACCGGTTTGTCTA-1	Interneurons1
CTTAACAAGTCATTGA-1	IPC
CTGGTCAAGAGAGGCT-1	Deeper Layer
CTTCATCCAAGGATTA-1	RG, Astro, OPC
CTTCAGGAGAAAGGAA-1	Ependymal cells
CTTGAACAGTAGGCGG-1	Upper Layer
CTTATTGGTGAAACAA-1	Upper Layer
CTGATCACACTTGTTC-1	Deeper Layer
CTGTATTTCCGGAACC-1	Deeper Layer
CTTACCTCAATATACC-1	Deeper Layer
CTTAAGGGTCCAAGAC-1	Interneurons2
CTTAGTTTCATTTGCT-1	Deeper Layer
CTGCTATGTCAGGAAG-1	V-SVZ
CTGTTAAAGCAGGTGG-1	V-SVZ
CTTCTCAAGTATTGCA-1	Upper Layer
CTGCTCCCACCTACGG-1	Deeper Layer
CTTCAAGCATCCCTCA-1	Ependymal cells
CTTCAGGAGTCACCAG-1	RG, Astro, OPC
CTTAACAAGTAACGAG-1	Deeper Layer
CTTCAAGCACCGGTAT-1	V-SVZ
CTGGACCAGTTAGTTG-1	Interneurons2
CTGCTCCCACCTCGCT-1	Deeper Layer
CTTGAATCACAGCCAT-1	Ependymal cells
CTGGTTTGTCGCAAAC-1	Upper Layer
CTTCGCGTCGCTAGTG-1	RG, Astro, OPC
CTTCTCAAGACCATAC-1	Subplate
CTGGTTACATTGTCAG-1	V-SVZ
CTGGTAAGTGTTCCCA-1	Upper Layer
CTTCTCAAGTTATGTG-1	Deeper Layer
CTGCAATAGAACAAGT-1	Interneurons3
CTGGCTAAGCGCATTG-1	RG, Astro, OPC
CTGTACCTCCCATAAA-1	RG, Astro, OPC
CTGGTAAGTGCGCGTA-1	Cajal-Retzius
CTGCTCCCAGGGAGGA-1	Deeper Layer
CTTGCATGTGCTTACT-1	Deeper Layer
CTGTATTTCAACAAGG-1	Interneurons2
CTGGATGTCGCAAACT-1	V-SVZ
CTGCAATAGGCGGGTA-1	Upper Layer
CTTAACAAGCGTGCAC-1	RG, Astro, OPC
CTTCGCGTCCCGCAAA-1	Deeper Layer
CTGTATTTCGTACCGA-1	Interneurons2
CTTATGTTCTGTAAGC-1	RG, Astro, OPC
CTTCACTCAGCAACCT-1	RG, Astro, OPC
CTTCAGGAGGTTTGCG-1	Interneurons2
CTGCTCCCAATAGTCT-1	Deeper Layer
CTTCAAGCAGGTTTGC-1	IPC
CTTCAGGAGGACTAAG-1	RG, Astro, OPC
CTTGCAACAGGTTAAA-1	Interneurons1
CTTCAGGAGTATTGGC-1	Interneurons1
CTTGAATCACAGGATG-1	Interneurons3
CTTAGGAGTCGTTATC-1	V-SVZ
CTTGAATCATGAATCT-1	Deeper Layer
CTTGAATCATAGCGAG-1	Upper Layer
CTTGAATCATTAGCGC-1	RG, Astro, OPC
CTGGATGTCCACCCTG-1	Interneurons1
CTTAATGAGTAGGATG-1	Upper Layer
CTGCTACTCATGCTAA-1	Interneurons1
CTGTTGGAGGATCACT-1	V-SVZ
CTGGTTACAATCGCAC-1	Upper Layer
CTTGCAACAGCTTAAT-1	Upper Layer
CTTAAGATCACCTGTC-1	Deeper Layer
CTGCTATGTATTTGGG-1	Subplate
CTGTATTTCCGCCTCA-1	IPC
CTTAAGGGTTTCAGGA-1	IPC
CTTAATGAGCCGCAAC-1	Interneurons2
CTTGACGAGCTTCTCA-1	Interneurons3
CTTCAGGAGTCACTAA-1	Interneurons3
CTTCATCCAATGAAGC-1	Deeper Layer
CTTCACTCAACCTAAT-1	Upper Layer
CTGTACCTCATGCCTC-1	Upper Layer
CTTATTGGTCTTTGAC-1	Upper Layer
CTTGAATCAAGTAAGC-1	Interneurons2
CTGGCTAAGTGAGCAA-1	Upper Layer
CTGTACCTCCTAATAG-1	Deeper Layer
CTTATGTTCGCTAAGT-1	Deeper Layer
CTTACTAGTAACGTGC-1	V-SVZ
CTGCTACTCGTTTCCA-1	Deeper Layer
CTGCTCCCAAGGACCA-1	Deeper Layer
CTTCAAGCATCAATCG-1	RG, Astro, OPC
CTTAAGGGTTCAAGAT-1	V-SVZ
CTTCATCCATGTGGGA-1	Deeper Layer
CTGTGTGAGGCATGAA-1	V-SVZ
CTGTATTTCTAAGTCA-1	Upper Layer
CTTAAGGGTTTATCTG-1	Upper Layer
CTTAGTTTCCTTAGTT-1	Interneurons2
CTTGCAACAAGGATTA-1	Upper Layer
CTGGCTTTCACTAAGC-1	V-SVZ
CTGCTCCCATCCTGAA-1	Interneurons1
CTTCACTCACTGACCG-1	V-SVZ
CTGGTTACATTTAAGC-1	RG, Astro, OPC
CTGCTACTCATGCTCC-1	RG, Astro, OPC
CTTTGAGCAATTATGC-1	Interneurons1
CTTTGAGCAGTCTAGC-1	Upper Layer
CTTGTCCAGCGAGCGA-1	V-SVZ
GAAGGATGTCAAACTG-1	Deeper Layer
GAAGCCTGTCAATAGT-1	Subplate
GAACTTATCTAATCCT-1	RG, Astro, OPC
CTTGTTTAGGCTCATG-1	V-SVZ
GAACCTGTCCTTGCGT-1	IPC
GAACCGCTCTGCAACG-1	RG, Astro, OPC
CTTTAGTTCATGCTAA-1	Interneurons2
CTTTAGGCACCTGTAA-1	Upper Layer
GAATTTGTCCAAACAC-1	RG, Astro, OPC
CTTTGAGCAACCGCCA-1	RG, Astro, OPC
GAACCAGCAGGAACTG-1	Deeper Layer
GAACCTGTCCCTCAGT-1	Ependymal cells
GAAGGATGTTGTCCAT-1	Upper Layer
CTTGTTTAGCGATAGA-1	V-SVZ
CTTTATGGTAAGGTCC-1	Upper Layer
GAAGTCAAGCATGGTT-1	Interneurons1
CTTTAGGCAGTTTCTC-1	Subplate
GAACCAAAGTAATCCA-1	Deeper Layer
CTTTATCAGCCTGTGA-1	IPC
GAAAGGCTCATTGACA-1	Interneurons1
CTTTGGTGTTGCGGAT-1	V-SVZ
GAACACAAGGGACGCA-1	Upper Layer
GAACGAATCCTCACTA-1	Deeper Layer
CTTGTTTAGACACTTA-1	Upper Layer
GAACCAAAGGACAACA-1	Deeper Layer
GAAAGCCAGCACGTTG-1	Deeper Layer
GAACACAAGGCTTAAC-1	Interneurons2
GAACCTGTCTAAGGTC-1	RG, Astro, OPC
GAACCTTAGGGACGCA-1	V-SVZ
GAACCTGTCCGGAACC-1	Upper Layer
GAAGCTAAGAGAGGAG-1	RG, Astro, OPC
GAACCAGCAACCTAAT-1	Deeper Layer
GAAGGCCCAGGTTAAA-1	Upper Layer
GAAGGATGTAATCACG-1	IPC
GAAAGGCTCCTCACAC-1	Upper Layer
GAAGCTAAGGAACGGT-1	Deeper Layer
CTTGCGCGTGCACGCA-1	Upper Layer
CTTGTAAAGTGAAGTG-1	Interneurons2
CTTTAGTTCAGCACGC-1	Interneurons1
GAAGCTAAGAAGGTGC-1	Upper Layer
CTTTATGGTTTAACCC-1	RG, Astro, OPC
CTTGCTCAGCCAGTAT-1	Deeper Layer
GAAGGCCCAGGCATCT-1	RG, Astro, OPC
GAACTTATCACTCAAA-1	Subplate
GAACCAAAGGCTTAGT-1	Interneurons3
CTTTCTTGTAGGTTTG-1	Deeper Layer
CTTGTCCAGGTGTTAC-1	Deeper Layer
GAAACCCGTTCACCCA-1	V-SVZ
GAACCAGCAATCCCTT-1	Deeper Layer
GAACCAGCAGCCAGAA-1	IPC
GAAGGATGTGGATTCA-1	Deeper Layer
GAACCTTAGTCCTTTG-1	Interneurons1
GAAGGCCCACCAACCG-1	Deeper Layer
CTTGTAAAGGAAGCTA-1	Upper Layer
CTTTAGGCAGTTTGTG-1	Interneurons2
GAATTTGTCAAAGGCA-1	RG, Astro, OPC
GAAAGCCAGCCGCTTT-1	Upper Layer
CTTGTCCAGTACTGGT-1	V-SVZ
GAAGTGATCGTAACGT-1	V-SVZ
GAACCAAAGCTAATCA-1	V-SVZ
GAAGTCAAGGTGAAGC-1	RG, Astro, OPC
GAAACCCGTCCCGAAG-1	Cajal-Retzius
GAAACCCGTGTAATAC-1	RG, Astro, OPC
GAACACAAGCCACATG-1	Upper Layer
GAAGTAAGTACGCGCA-1	V-SVZ
GAAGGCCCATTAAGCT-1	Deeper Layer
GAATTTGTCATTGCGG-1	Interneurons2
GAAGGAACACTGACTA-1	Upper Layer
GAAGTATAGACTTATG-1	RG, Astro, OPC
CTTTGAGCAAACGGGC-1	Upper Layer
CTTTGAGCAAACTGTT-1	Deeper Layer
GAAGGCCCATGCTATG-1	Upper Layer
CTTTGAGCAAATATCC-1	IPC
GAACCGCTCTACCTCA-1	Interneurons3
GAAACCCGTTGGCGTG-1	RG, Astro, OPC
CTTGTCCAGGAAGCTA-1	Deeper Layer
CTTTGGTGTGTTGTAG-1	Interneurons2
GAACCAGCATGAGCAG-1	Interneurons3
GAAAGCCAGTCACTAA-1	Interneurons2
GAAGTGATCATCGTTT-1	Interneurons2
GAACGAATCACGCATG-1	Interneurons2
CTTGTCCAGTTGCGTG-1	IPC
GAAGTATAGGAAGCTA-1	V-SVZ
GAACCTGTCCACAATA-1	Upper Layer
GAAGGATGTTAATCGG-1	Interneurons2
GAAGCCTGTTGACTTC-1	RG, Astro, OPC
CTTTAGGCAAGGTCCT-1	V-SVZ
CTTGGACCACACAATT-1	V-SVZ
GAAGTGATCCTGAGTG-1	V-SVZ
CTTTAGTTCACCGGTA-1	Upper Layer
GAAGTAAGTAACGGGA-1	RG, Astro, OPC
CTTTAGTTCCCGTTTA-1	Upper Layer
CTTTAGTTCGAAGTAG-1	RG, Astro, OPC
GAATTTGTCGCTAGCA-1	IPC
GAACTTATCATTGTCT-1	Deeper Layer
GAGAACCAGTTTCCTG-1	Deeper Layer
GACCTGATCGGTTACG-1	Interneurons3
GAGCAAATCTTTGACT-1	Upper Layer
GACCGAACATGAATAG-1	Upper Layer
GACGTAAAGGAAGCAC-1	Upper Layer
GACCTCAAGGCTTAGT-1	Interneurons1
GACCGAACACTGGCTG-1	Interneurons3
GACCTAGTCTTGGACG-1	Upper Layer
GAGCAAATCTAATCAG-1	Interneurons3
GACGCAACACCTAAGC-1	RG, Astro, OPC
GACGCAACATAAGTCT-1	Ependymal cells
GAGAACCAGGCCAATT-1	Deeper Layer
GACGCCTAGGAGCACG-1	Interneurons2
GACTTACAGTTGGGCC-1	V-SVZ
GACTTACAGCACGTTG-1	Upper Layer
GACCTAGTCGGTTTCC-1	Upper Layer
GAGAAACGTGTCCAGG-1	Ependymal cells
GACGTAAAGTTACTTC-1	RG, Astro, OPC
GACGTAAAGTTATGGC-1	Interneurons1
GAGAACCAGCTCGCTT-1	Deeper Layer
GAGAAACGTTCATTTG-1	Deeper Layer
GACATAGAGCTTATGA-1	V-SVZ
GAGAACCAGGAAGCAC-1	Deeper Layer
GAGCAAGGTTACTTCA-1	Deeper Layer
GACTAATGTAGCTGCG-1	Deeper Layer
GAATTTGTCTCCTCTT-1	Deeper Layer
GACCTGATCGACAAAG-1	Deeper Layer
GACCTAAGTCCCGGAA-1	Deeper Layer
GACCGTTCAAATTGCT-1	Deeper Layer
GACTTGGTCGGTTTGG-1	Subplate
GACGCCTAGCGGTTAT-1	Subplate
GAGATAAGTATTGAGT-1	Ependymal cells
GACCTGATCGCAAACT-1	Interneurons1
GACTAATGTCAATGTG-1	Interneurons3
GACTTGGTCTCGCCCA-1	V-SVZ
GACTTAGGTGCATCGG-1	RG, Astro, OPC
GAGCCACTCACAGCCA-1	Deeper Layer
GACCGAACAGTTTACG-1	Interneurons1
GACATAGAGTTAGTGC-1	Interneurons1
GAGCAAATCATGCCTC-1	RG, Astro, OPC
GACCGAACATGGCCTG-1	V-SVZ
GACCTTTGTCCCGAAG-1	Upper Layer
GAGCAAATCATTTGTC-1	RG, Astro, OPC
GAGCATGCAAGACTCC-1	Upper Layer
GAGCCACTCATGCTCC-1	Upper Layer
GACCGAACATTGTGTG-1	Deeper Layer
GACTTACAGGTCCACA-1	RG, Astro, OPC
GACGTAAAGTTAGCTA-1	Upper Layer
GACCTTTGTTGGTTAG-1	Upper Layer
GACTAATGTGTGCAAC-1	IPC
GACCTAAGTTAGCTGA-1	Interneurons2
GACCTAAGTGCTCACC-1	Ependymal cells
GACACTAGTTCGCTCA-1	V-SVZ
GAGCATGCAGGTTAAA-1	RG, Astro, OPC
GAGCAAATCAATAGCC-1	Deeper Layer
GACCTGCAGTCACGAT-1	V-SVZ
GACCTCAAGACAGGTA-1	Ependymal cells
GACCGTTCACAGGAAT-1	RG, Astro, OPC
GACTCACCATACTCCT-1	V-SVZ
GACTTAGGTATTACCC-1	Upper Layer
GACCTAAGTGATCAGC-1	V-SVZ
GACCTTTGTCCGTAGG-1	Interneurons1
GAGATAAGTTGCTTCG-1	Upper Layer
GAGAACCAGCGATAGA-1	Cajal-Retzius
GACTCACCACCTCAGG-1	V-SVZ
GACGTAAAGAGGAAGG-1	Upper Layer
GAGCCACTCATTACGA-1	Upper Layer
GACCGAACAAAGCGGC-1	Deeper Layer
GACCTAAGTACAAAGA-1	Upper Layer
GACACTAGTTACAACG-1	Deeper Layer
GACTTGGTCGGTTACG-1	RG, Astro, OPC
GACATTATCAACAAGG-1	Ependymal cells
GAGCCACTCACTCGCT-1	Upper Layer
GACCTTTGTGTGTCCC-1	Upper Layer
GACAATACATAATCAC-1	V-SVZ
GAGAAACGTTGAGGTC-1	V-SVZ
GACCTTTGTGCACGCA-1	Upper Layer
GACACTAGTTTGCAGA-1	Upper Layer
GACCGAACAAGACTCC-1	Deeper Layer
GAGAACCAGCGTGCGT-1	V-SVZ
GACCTAGTCTAAGTGC-1	Deeper Layer
GACTTACAGGAGTCTT-1	Upper Layer
GACCTGCAGAAACTGG-1	Deeper Layer
GACCTAGTCAAGCCTG-1	RG, Astro, OPC
GAGCAAATCCTAGTAA-1	RG, Astro, OPC
GAGATAAGTCGTAAAT-1	Upper Layer
GAGCAAATCCTAAGGT-1	Interneurons1
GAGGCTTGTTCATTTG-1	Deeper Layer
GAGGTGAGTTAGTACG-1	Interneurons1
GAGGTACAGCACTAGT-1	Ependymal cells
GATCACTAGGGCCACT-1	Upper Layer
GAGTAACCATTAAGTC-1	V-SVZ
GATCAGTTCGATTTGA-1	V-SVZ
GAGCTGCTCCGCAAGC-1	Interneurons1
GATCAGTTCATAACCA-1	IPC
GAGGTACAGCACAGCC-1	Upper Layer
GATAAAGGTATTACCC-1	RG, Astro, OPC
GAGCTAGCATGTGGGA-1	Subplate
GAGTATCTCCCTGGAA-1	Microglia
GAGTTACTCCTAGTCC-1	Upper Layer
GAGTGTTTCCTGCGAA-1	V-SVZ
GAGGTAGGTCTAGCTT-1	Upper Layer
GAGGTAGGTGAAGCCT-1	Upper Layer
GAGCTTGTCCAGCACA-1	V-SVZ
GAGGGAGCACATAGCC-1	Interneurons1
GAGCTAGCATGATTGT-1	Upper Layer
GATAACGAGCACTAAC-1	V-SVZ
GAGCGATAGGGCTAAA-1	Deeper Layer
GAGTAATAGTGAGGTA-1	Deeper Layer
GAGTCATTCGCGCTAA-1	Interneurons2
GATCAGTTCAGCACCA-1	Upper Layer
GAGGTGAGTCCAAGAC-1	Upper Layer
GAGGAGGCAAGACTCC-1	Deeper Layer
GAGTGTTTCCGCACAA-1	Interneurons2
GAGGGAGCACTGACTA-1	RG, Astro, OPC
GAGTATCTCGGGCCAT-1	Deeper Layer
GAGTGTTTCGCGACAC-1	Upper Layer
GAGTTTGGTATTGTCC-1	Deeper Layer
GAGTAATAGTTGGCCA-1	Upper Layer
GAGTTTGGTGCACGCA-1	Interneurons2
GAGTTTGGTGTGCAAC-1	RG, Astro, OPC
GAGTAATAGTTCCTCA-1	Interneurons2
GATAAAGGTCTTTATG-1	Interneurons2
GAGCGGTCAGGGAGGA-1	Interneurons1
GAGTCAAAGCCAGTAT-1	V-SVZ
GATCCGTCAGTTTCTC-1	Interneurons1
GATCAGTTCCCTGTTA-1	Upper Layer
GAGGACTAGGGTGAAC-1	Upper Layer
GAGGTACAGGCAAGTA-1	Deeper Layer
GATAAGCCAGCTTAAT-1	RG, Astro, OPC
GAGGACTAGCACTAAC-1	Upper Layer
GAGCTTAGTAAGCTTG-1	Subplate
GATCAAGAGGACTAAG-1	Upper Layer
GAGTTTGGTACTAAAC-1	RG, Astro, OPC
GATCAAGAGTGAACGA-1	Upper Layer
GAGGAGGCAACAGGAT-1	Deeper Layer
GATCAGGCACTGACTA-1	Ependymal cells
GATAGACCATGGAGGC-1	V-SVZ
GAGCTTGTCATTTAGG-1	Ependymal cells
GAGTCAAAGTAACAGG-1	Upper Layer
GAGGCTTGTGGCTTCC-1	V-SVZ
GAGGTTAAGTAGGATG-1	IPC
GAGTCATTCTGTGCAG-1	Upper Layer
GAGCTTGTCCTTAATC-1	Interneurons2
GAGGTAGGTAGTCAAT-1	Upper Layer
GAGCGAAGTTTATGGG-1	RG, Astro, OPC
GAGCTAGCACCTGGTG-1	Upper Layer
GATCAGGCAGTCTATG-1	RG, Astro, OPC
GAGGTACAGTTTGGGT-1	V-SVZ
GAGCTGCTCCTTGCGT-1	Subplate
GATCAGTTCTAAGTGC-1	Subplate
GAGTGATCACAATTAC-1	Deeper Layer
GATAACGAGACTAAGG-1	Upper Layer
GAGTGTTTCGCAAACT-1	Interneurons2
GAGCGGTCACCTAATG-1	Interneurons1
GATAGACCAGGATAAC-1	Upper Layer
GATAAAGGTCCTCCAA-1	Deeper Layer
GAGTGAGGTTTAGCTC-1	RG, Astro, OPC
GATCGAGCAGAAATGC-1	Ependymal cells
GATCCGTCAAGCGAGC-1	Deeper Layer
GAGTTTGGTCATCATC-1	IPC
GAGCTGCTCGTTACTT-1	Upper Layer
GATCAGGCACTTAGGC-1	Ependymal cells
GATAAGCCAATTGCGC-1	Upper Layer
GAGTGAGGTTGTTGTC-1	Deeper Layer
GATCAGGCAATGCCTA-1	Deeper Layer
GATCGAGCACGGTTTA-1	V-SVZ
GATAGACCACATACTG-1	Interneurons1
GAGTTTGGTTGCAATG-1	Deeper Layer
GAGCGAAGTTATCCGT-1	V-SVZ
GAGGCAAGTACCCACC-1	Deeper Layer
GATAACGAGCTATTAG-1	Ependymal cells
GAGCCACTCTCCATAT-1	Deeper Layer
GATCGAGCAGGCCAAA-1	V-SVZ
GATAATCGTTGCGCGA-1	Upper Layer
GAGGAGGCATTGCGTA-1	Upper Layer
GATTCGCCAACAGGAT-1	V-SVZ
GATTATGTCACGAATC-1	Subplate
GATTCAATCTAATCTC-1	Upper Layer
GCACTAAGTCCAAATG-1	Upper Layer
GCAATGAAGGAACGCG-1	Upper Layer
GATCGCTCAGGTTAAA-1	RG, Astro, OPC
GATTCAATCTTCAATC-1	Deeper Layer
GCAAGTGCAAGTAAGC-1	V-SVZ
GATTGGTTCACTTTAC-1	Interneurons2
GCAATAGAGAGCAAGC-1	Upper Layer
GATTCAATCTTTAGGA-1	Interneurons3
GCACCTAAGGCGAATA-1	RG, Astro, OPC
GATTGCGTCTGTAATG-1	Cajal-Retzius
GATGCTTAGCCGCAGT-1	Upper Layer
GCAATGAAGTGCACGC-1	V-SVZ
GATTCGCCAGCTTACA-1	Deeper Layer
GATTCAGGTAGGTTGC-1	Upper Layer
GCACGCTAGTATTGCA-1	Interneurons1
GCAAGTGCAGTAAGTA-1	Upper Layer
GCAATAGAGTTGGCCA-1	Upper Layer
GATGAGGGTGAACAAA-1	Interneurons2
GATTCAATCCACCCTG-1	Ependymal cells
GCACTAAGTCCGCTGT-1	Upper Layer
GATTGCAGTTCCGGCT-1	V-SVZ
GATGGACAGTGCTGTG-1	Deeper Layer
GATTGGCGTATTGGTG-1	V-SVZ
GATGAGGGTTTAGTCC-1	RG, Astro, OPC
GATGCATTCTAATCAG-1	Interneurons2
GCACCTAAGGTGAAGC-1	IPC
GCAGCAACAGTATGTT-1	Upper Layer
GATTAAGCACCAGGTT-1	Microglia
GCACGCTAGCAGCTCA-1	RG, Astro, OPC
GATTCGCCAGAATGAC-1	RG, Astro, OPC
GCAATCTAGGAGCATA-1	Upper Layer
GATTGGCGTTTGCAGA-1	IPC
GATCGAGCATCACTTC-1	Interneurons1
GCACGCTAGTTCCTCA-1	Upper Layer
GCACTAAGTCATAACG-1	V-SVZ
GCACATTAGCTTACTT-1	V-SVZ
GATTGGCGTCGCATAA-1	Deeper Layer
GCACCTAAGCGAGGTG-1	Upper Layer
GATGCGACATTATGCG-1	Interneurons3
GCAAACAAGTCATTTC-1	Deeper Layer
GATGCAGCATAATGTC-1	Subplate
GATTATGTCCCTGTTA-1	Upper Layer
GCAACAGCAGGCATGA-1	Upper Layer
GATTGATGTCTTGCAT-1	Upper Layer
GCAAACAAGTTGGGCC-1	V-SVZ
GATTCCTGTGATTTGG-1	Deeper Layer
GATTAAGCACTTACAG-1	Upper Layer
GATTCAGGTGTGAGGA-1	Interneurons1
GCAATCTAGTGAACGA-1	Ependymal cells
GCAAGTCGTAAAGCAA-1	V-SVZ
GATTAGTGTTGTAAAC-1	Interneurons1
GATCGCTCAGGATAAC-1	Deeper Layer
GATTACGGTACGTTTC-1	V-SVZ
GATGGACAGGGATTAG-1	RG, Astro, OPC
GATGCTTAGGAATAAC-1	V-SVZ
GATTGGTTCGGGATTT-1	Deeper Layer
GCAAACAAGTCACTAA-1	Subplate
GATGGACAGCCACAAT-1	V-SVZ
GCACTTACAGGAACTG-1	Deeper Layer
GCACGAACAGATTCAT-1	Upper Layer
GATTATGTCAAGCTAC-1	RG, Astro, OPC
GCAATGTTCTATTGTC-1	Upper Layer
GCAATCTAGTAGCCAT-1	Upper Layer
GATGGACAGAGAAGGG-1	Deeper Layer
GCACGGTTCTTAGTCT-1	V-SVZ
GATGAGGGTGATGATT-1	Deeper Layer
GATTCAGGTTGGTTCT-1	V-SVZ
GATTAGTGTAAAGCAA-1	Upper Layer
GCAACAGCATTAAAGG-1	Deeper Layer
GATGCGACAGCCAGAA-1	Upper Layer
GCACGGTTCAATTACG-1	Deeper Layer
GATCGCTCAACTAACT-1	Interneurons3
GATTAGCTCTGGCAAT-1	Upper Layer
GATTAGCTCCCGCAAA-1	Upper Layer
GATCGCTCATGACTAT-1	IPC
GATGGACAGTTTGTCT-1	Upper Layer
GCAAGTCGTATTTGCC-1	RG, Astro, OPC
GCAAACCGTTTGTTGC-1	Upper Layer
GATGCAGCATGGCCCA-1	RG, Astro, OPC
GATTCCTGTAAATTGC-1	RG, Astro, OPC
GATGCGACACGTAAGG-1	Subplate
GCAAACAAGCTGAGGG-1	Deeper Layer
GCAATCTAGAATGACG-1	Upper Layer
GCAAACTTCATAACGC-1	V-SVZ
GCACGAACAAGTTATC-1	V-SVZ
GCATGAGCATTAAGCT-1	Upper Layer
GCCTATTGTCTTGCAT-1	RG, Astro, OPC
GCCATGATCGATCAGT-1	Upper Layer
GCCACAATCAGCACCA-1	Upper Layer
GCCTCGACAACTGGCT-1	RG, Astro, OPC
GCCAACATCATCAGTA-1	Deeper Layer
GCAGCCAGTGTTTCAC-1	Deeper Layer
GCAGGCTTCACGCGGT-1	V-SVZ
GCCAATTAGGTACCGC-1	RG, Astro, OPC
GCCGTGAGTCAAAGAA-1	Deeper Layer
GCCTACTTCATGACCG-1	Deeper Layer
GCCTTACTCTGTAATG-1	Deeper Layer
GCATGAGCAGGATTAA-1	Interneurons1
GCCACTAAGTAATCCA-1	Upper Layer
GCAGGTTGTTGAATCG-1	Deeper Layer
GCCTTACTCCTCATGC-1	Deeper Layer
GCCTATTGTAGCTAGC-1	Deeper Layer
GCCAATAGTTACGCGG-1	Deeper Layer
GCCTTACTCGAGCAAA-1	Upper Layer
GCAGGAAGTAAATTGC-1	Deeper Layer
GCCTGTGCAAACGCGA-1	Upper Layer
GCCAACATCACTAAGC-1	Interneurons2
GCCTCAAAGACACTTA-1	Upper Layer
GCCTTAGAGCAGGTTT-1	RG, Astro, OPC
GCATGAAAGAAAGCAT-1	Deeper Layer
GCAGCTATCAGGATGA-1	Interneurons2
GCCAATTAGGCAATAG-1	IPC
GCCCGTTGTTGTAACG-1	Upper Layer
GCCTCAAAGGCTCATG-1	RG, Astro, OPC
GCCTATTGTATTGGAT-1	Cajal-Retzius
GCCTGTGCAGCAGGTA-1	Deeper Layer
GCCAACATCACACAGT-1	Subplate
GCCTCGACACTGACCG-1	RG, Astro, OPC
GCCAACATCGTTAGCG-1	Upper Layer
GCAGGATAGTAAAGGT-1	Interneurons1
GCCACACAGCTTCTCA-1	V-SVZ
GCATTGCCACCCTCAC-1	V-SVZ
GCCAACATCCCTCATA-1	Upper Layer
GCATGAAAGAACCTGT-1	Subplate
GCCTAATAGGACTAAG-1	V-SVZ
GCATCCTTCCTAAGAC-1	V-SVZ
GCCTGTGCAAGCCAGA-1	Deeper Layer
GCCTCAAAGCCAGTAT-1	V-SVZ
GCAGGTGAGGTTACGT-1	Upper Layer
GCCTCCATCGCATCCT-1	RG, Astro, OPC
GCATTGCCACTAAGCC-1	V-SVZ
GCCAGGAAGGAGTCTT-1	Deeper Layer
GCCTTGCGTTGTCATC-1	Deeper Layer
GCCTACTTCGCACAAT-1	V-SVZ
GCATGAGCAATTAGCT-1	RG, Astro, OPC
GCCAATTAGTCCTTCA-1	Upper Layer
GCCCATAAGGAGCAAC-1	RG, Astro, OPC
GCATGAGCACCAGCAT-1	Ependymal cells
GCAGCCAGTGGGTACT-1	IPC
GCCTTGCGTTTAAAGC-1	V-SVZ
GCCCAAATCCCGTTTA-1	Upper Layer
GCCTGTGCATCGCTTT-1	Interneurons2
GCCACAATCTTAGTGA-1	Ependymal cells
GCCTCGACATTATCCC-1	V-SVZ
GCATTGCCATTGTTGG-1	Subplate
GCCAACATCCCGCAAA-1	V-SVZ
GCCTGCTGTCCGTAGG-1	Upper Layer
GCCGTGAGTTAGCCAA-1	Interneurons3
GCCTGAGGTTTGTTGC-1	Interneurons3
GCAGGCTTCTTGTCCA-1	V-SVZ
GCCTCCATCCACCCTG-1	Deeper Layer
GCATGAAAGGCAGGTG-1	RG, Astro, OPC
GCAGCCAGTTAGGACC-1	Upper Layer
GCCTACTTCATTTGTC-1	Upper Layer
GCATCCTTCTGTTCAT-1	IPC
GCAGGAAGTTAGGACC-1	V-SVZ
GCATTGCCATTATGCG-1	Interneurons1
GCCTACTTCTAATCTC-1	Upper Layer
GCCAGGAAGGTACCGC-1	V-SVZ
GCATTGCCAATTGAAG-1	V-SVZ
GCATTAGGTTCGCGCT-1	Upper Layer
GCCACACAGTTTGGTA-1	Deeper Layer
GCCAACATCAGCACCA-1	RG, Astro, OPC
GCCCATAAGGTCCGTA-1	IPC
GCCGTGAGTCCCGAAG-1	Interneurons2
GCCTTTATCGTGCCTT-1	RG, Astro, OPC
GCCTAATAGCGGCTGT-1	Deeper Layer
GCATCCTTCCTAACGG-1	Upper Layer
GCAGGAAGTTGGCCGA-1	V-SVZ
GCCATTACAGCACCAT-1	Interneurons3
GCCCGTTGTGTCCAGG-1	Deeper Layer
GCAGGCTTCGTTTCGC-1	RG, Astro, OPC
GCCCATAAGTATTGGC-1	Upper Layer
GCAGGACCATAGCTTG-1	RG, Astro, OPC
GCTATAGGTTCCGGGA-1	V-SVZ
GCTAAGTTCCATAAGC-1	Interneurons3
GCGTGCTAGGGCCACT-1	Upper Layer
GCTAACAGTACAAAGA-1	Upper Layer
GCGGGTTTCGTTAGCG-1	Upper Layer
GCGTTTCTCCTTCAAT-1	V-SVZ
GCTATTGCAAACAACA-1	RG, Astro, OPC
GCGTGCTAGCTTATGA-1	V-SVZ
GCGTTTCTCGCACAAT-1	V-SVZ
GCGCGATTCAGCAAAG-1	Upper Layer
GCGATATTCTAACTGA-1	Upper Layer
GCGATTTAGGAAACTG-1	IPC
GCGATATTCTAATTGG-1	RG, Astro, OPC
GCTAACAGTCCTAACT-1	V-SVZ
GCTATAGGTATTGCAG-1	Interneurons2
GCGAAGCCAAAGCGCA-1	Upper Layer
GCGATATTCGAGGTGG-1	Interneurons1
GCTAAGAAGCGGATTT-1	Upper Layer
GCTAGCGGTGTTTCAC-1	Interneurons2
GCGCCTTGTCCAAGAC-1	Interneurons2
GCGTTTCTCTTAGGAC-1	IPC
GCTATTGCAGCTTAAT-1	Upper Layer
GCTATCCTCTCCATGC-1	Upper Layer
GCGAAGCCATAAGTCT-1	Microglia
GCGCAAACACAGAAAC-1	IPC
GCTATCCTCTTGCAAA-1	RG, Astro, OPC
GCGGGTTTCGCTAAGT-1	V-SVZ
GCGAAGTAGGAATAAC-1	Deeper Layer
GCTAGCCAGCTTACTT-1	Upper Layer
GCGCAAACACAACAAA-1	Upper Layer
GCTAAGAAGCTAGAAG-1	RG, Astro, OPC
GCGCTTGCATAAACCT-1	Interneurons1
GCGCAATGTTACTTGC-1	Deeper Layer
GCGAGTGAGGGTGAGT-1	Subplate
GCTATAGGTCTAACAG-1	RG, Astro, OPC
GCGCAATGTTGTTCAC-1	Interneurons3
GCTAGCCAGCTATGAC-1	Ependymal cells
GCTAATATCGTTATCT-1	V-SVZ
GCGGAACCACGGTTTA-1	Ependymal cells
GCTATCCTCATAAGCC-1	Interneurons2
GCTATTGCACCTAAGC-1	Deeper Layer
GCTAATATCCCTGATC-1	Deeper Layer
GCTATCCTCCTAATGA-1	V-SVZ
GCCTTTATCTCCATGC-1	V-SVZ
GCGCAATGTCCGGTTC-1	Deeper Layer
GCTAAGAAGGGTGGAT-1	V-SVZ
GCTAGCTCATCACTTC-1	Interneurons1
GCTAGCGGTTAGTGAT-1	RG, Astro, OPC
GCTAATATCCAAACAC-1	V-SVZ
GCGTTTCTCAGGAAGC-1	Interneurons1
GCTATAGGTCCTTCAG-1	Interneurons3
GCTAATATCAAGCGCC-1	Deeper Layer
GCGATTTAGCTTAGCG-1	Upper Layer
GCTATTGCAATAACGA-1	Upper Layer
GCGATTAGTTAAATGC-1	Subplate
GCGAAGCCACAGGATG-1	Deeper Layer
GCTAACAGTAACCACA-1	Deeper Layer
GCTAGCTCATGCTCCC-1	RG, Astro, OPC
GCTAATATCAGCACGC-1	V-SVZ
GCGGAACCAGAGGGAG-1	Deeper Layer
GCGGAACCAGCAATAA-1	Subplate
GCTAAGTTCCTAAGGT-1	Upper Layer
GCGGTTGGTGCTGGTG-1	Upper Layer
GCGCAAACATTCAGCA-1	RG, Astro, OPC
GCGGGTTTCCAACTGG-1	Upper Layer
GCGGTTGGTTTACCGT-1	Interneurons2
GCTAATATCATGCTAA-1	Upper Layer
GCGCTAGGTAACGTGC-1	Interneurons3
GCTAACAGTTAGGTTG-1	Cajal-Retzius
GCGCTAGGTACTGAAT-1	Deeper Layer
GCGTAACGTAGACAAA-1	Interneurons1
GCTAAGCGTTGGGTTA-1	Upper Layer
GCTAAGTTCAAACCTA-1	Upper Layer
GCTAGCTCAGGAACTG-1	V-SVZ
GCTAACCCACCTCAGG-1	Interneurons1
GCGAAGTAGTTATCCT-1	Interneurons3
GCTATAGGTAGTAAGA-1	RG, Astro, OPC
GCGCTTGCACTGACTA-1	Upper Layer
GCTAAGTTCTTACTCG-1	IPC
GCGATTAGTACAATGT-1	V-SVZ
GCGCCTTGTAATCGTG-1	V-SVZ
GCTATTGCACAGGGAC-1	V-SVZ
GCGCTTGCACACCAAC-1	Interneurons1
GCGCTTAAGTTACTTC-1	Interneurons2
GCGCTAGGTTCCTCCT-1	V-SVZ
GCGGTTGGTTCCGGGA-1	V-SVZ
GCTAAGAAGCTTAGCG-1	Ependymal cells
GCTATCCTCGCTAGCA-1	RG, Astro, OPC
GCTATTGCAAACTCAT-1	Interneurons1
GCGAAGTAGTGATTCA-1	Upper Layer
GCTAAGAAGGCGCTAC-1	Deeper Layer
GCTTTACGTTGCTTCG-1	Upper Layer
GGAACGGTCCGCCTCA-1	Interneurons2
GCTGCACAGTCTGGGC-1	Deeper Layer
GCTGACATCAGGTTTA-1	Upper Layer
GCTTCGCGTCTTACTA-1	Ependymal cells
GGAACGGTCCATCAGG-1	Interneurons1
GGAAGCTAGCATGGTT-1	Interneurons1
GCTGTGCAGAGAGGCT-1	V-SVZ
GCTTATCGTAATTAGC-1	Interneurons3
GCTTATCGTTAGTGAT-1	Deeper Layer
GCTTAGTAGTGATTCA-1	V-SVZ
GGAAACTCAGCAAATA-1	Upper Layer
GCTGCACAGCAAGGTA-1	V-SVZ
GGAACGGTCACAGACT-1	V-SVZ
GCTTTGTGTCAAGACC-1	IPC
GCTCGATCACCACAAC-1	Deeper Layer
GGAACGGTCCAGGTTG-1	Deeper Layer
GCTGCATCATGATTGT-1	Upper Layer
GCTCGATCAAGGTATA-1	RG, Astro, OPC
GCTGAGGAGTATCGCG-1	Deeper Layer
GCTCAACCAATTGCGC-1	Subplate
GCTCATTGTACGGGTT-1	Deeper Layer
GCTGATCCACGAACAG-1	Upper Layer
GCTCAACCAGCAGGTA-1	Deeper Layer
GCTGACATCCTAATAG-1	Ependymal cells
GCTTGACCATTGCGAC-1	RG, Astro, OPC
GCTTTATTCAATTGGC-1	Deeper Layer
GCTGCACAGTTTGCGG-1	Interneurons1
GGAACGGTCCTGGTGA-1	IPC
GCTTTGTGTTCCTGTG-1	Interneurons1
GCTCCTTAGTTCCCGT-1	Deeper Layer
GGAACCACAAGGGTTG-1	V-SVZ
GGAACCTGTAGTAAGA-1	V-SVZ
GCTCTGTTCCCGAACA-1	Upper Layer
GCTTTACGTTGTAAAC-1	Upper Layer
GCTTGTTGTGCGCATG-1	RG, Astro, OPC
GCTTAAATCCGCCTAT-1	Deeper Layer
GCTGCATCATAGACCC-1	Upper Layer
GCTCTGGCAGGACACA-1	RG, Astro, OPC
GGAACAATCCAGGTTG-1	RG, Astro, OPC
GGAACTAAGGTCAAAG-1	Subplate
GCTGAGGAGATTGAGG-1	Upper Layer
GCTTTCATCACAAGCT-1	V-SVZ
GCTTCGCGTCAGTAAT-1	Interneurons1
GCTGAGGAGAGGCTAA-1	Subplate
GCTTTGTGTCCTAGTT-1	Upper Layer
GCTGACCAGCTTATGA-1	Deeper Layer
GCTTTCATCGCCTAAG-1	Upper Layer
GGAAACTCAGCAGGTA-1	Interneurons2
GCTGATCCATAAAGCA-1	Upper Layer
GGAACAATCCTAGTAA-1	Upper Layer
GCTGGTTCACTTACAG-1	V-SVZ
GCTTTATTCCGGTTAG-1	Upper Layer
GCTGCATCAGCTTAGC-1	Interneurons1
GGAAACTCATTGACAT-1	Upper Layer
GCTGTGATCGCATTAA-1	Upper Layer
GCTTGACCAATAATGG-1	Upper Layer
GCTTAAATCCTGGTGA-1	V-SVZ
GCTTTATTCGGTTTGG-1	V-SVZ
GCTTATCGTCCTAAGA-1	RG, Astro, OPC
GGAACGGTCGCGCTAA-1	RG, Astro, OPC
GCTGTGATCATTTGTC-1	RG, Astro, OPC
GCTGCATCAGTTTGGC-1	RG, Astro, OPC
GCTGCACAGGGACCTC-1	Deeper Layer
GCTGCACAGAAAGCAT-1	Upper Layer
GCTGCACAGGATCCGC-1	Deeper Layer
GCTGGATGTGCGCAAT-1	Deeper Layer
GGAACCTGTGCTGGTG-1	Upper Layer
GCTTAACAGTGAGAGC-1	Subplate
GCTGACCAGGAACACA-1	RG, Astro, OPC
GCTCCTTAGTAACCCG-1	V-SVZ
GCTTTCATCCTCAGTC-1	RG, Astro, OPC
GCTTAAATCATGCTCC-1	Interneurons1
GGAAACTCATCATGTG-1	V-SVZ
GCTTATCGTGATCAGC-1	Deeper Layer
GCTGACCAGACAAACG-1	Interneurons3
GCTTATCGTTTCCTCC-1	Upper Layer
GGAACGGTCTAACTGA-1	Interneurons2
GCTCATTGTCGCAATA-1	Deeper Layer
GCTTAAATCACCTGCT-1	Deeper Layer
GGAACGGTCCGGCTAA-1	Subplate
GCTCTGGCATTGGGAG-1	Upper Layer
GCTGACCAGCGTGCAC-1	V-SVZ
GCTTGACCAATCCCTT-1	Upper Layer
GGAACCACACTTAACG-1	V-SVZ
GCTGCATCATCGCTCC-1	Upper Layer
GCTGTAAGTTAGGTGC-1	Upper Layer
GCTGTGCAGGTGAGAC-1	RG, Astro, OPC
GCTGACCAGGCCTAAT-1	V-SVZ
GCTTTATTCGCTAGAT-1	V-SVZ
GCTGACATCCGGTTAG-1	Deeper Layer
GCTTAGTAGATACTTG-1	V-SVZ
GCTCTGGCAGTCTATG-1	Interneurons1
GGAAGCTAGTCAATCA-1	Interneurons1
GGATAACCATGTTTGG-1	Deeper Layer
GGACTAAAGGCTTAAC-1	RG, Astro, OPC
GGAAGTATCGGCCATA-1	IPC
GGACTAAAGGAGGCAT-1	V-SVZ
GGCGGTTTCCTAAGGT-1	Interneurons1
GGATATTGTGGACCTG-1	V-SVZ
GGAAGCTAGGTTAGCT-1	Deeper Layer
GGATAACCATGAAATG-1	Interneurons1
GGCGCTAGTTGAATCG-1	Upper Layer
GGACGGATCCGCCTAT-1	Upper Layer
GGACTAAAGCCTTAAA-1	Interneurons1
GGCAATCGTTGTAACG-1	Upper Layer
GGACCGAAGCATTAGC-1	Upper Layer
GGCATTAGTAGCTAAT-1	Upper Layer
GGATGTAAGTAAGGGC-1	V-SVZ
GGATACTTCGTTTCTG-1	Upper Layer
GGCCATCAGGCGCTTA-1	Deeper Layer
GGAGTGAGTGACCTGG-1	Upper Layer
GGCCGTTAGGGCTAAA-1	Upper Layer
GGAAGCTAGTTTGCGG-1	Upper Layer
GGATACTTCTTTAAGG-1	Interneurons1
GGCGGTAAGCTTCCCG-1	RG, Astro, OPC
GGAGGTTAGTTTGTCT-1	Upper Layer
GGCAAATCAGAAACGT-1	V-SVZ
GGACGGATCCGTCCAT-1	Deeper Layer
GGATGGCCACTATGGC-1	V-SVZ
GGACCGAAGGCTACTG-1	V-SVZ
GGACTAAAGCATCCAG-1	Upper Layer
GGAGCATAGTTATCCT-1	Deeper Layer
GGCAGGATCCTAAATG-1	RG, Astro, OPC
GGCCTTAAGGCTACTG-1	Upper Layer
GGCAAATCAATAAGCA-1	Interneurons2
GGAAGCTAGTCATGCG-1	Interneurons1
GGAGTGAGTATGTGGC-1	V-SVZ
GGACGGATCTGTTGCC-1	Upper Layer
GGATGAATCAATCTAG-1	IPC
GGCCATCAGCAGCTAT-1	Deeper Layer
GGAGCATAGGCCAATT-1	V-SVZ
GGCGGTAAGTCATCCC-1	Upper Layer
GGATGGCCAACCTGGT-1	Interneurons3
GGAGCATAGCGCTAAT-1	RG, Astro, OPC
GGCCTCTGTTACGCAA-1	V-SVZ
GGAAGTATCCCTCAGT-1	IPC
GGCGGTTTCAGGGCCT-1	Upper Layer
GGAGTGAGTGAAACAA-1	Upper Layer
GGAGCAAGTTACAACG-1	Deeper Layer
GGAGTGAGTTGAATCG-1	Interneurons2
GGCAAGCCATTGCGAC-1	V-SVZ
GGAATCTTCAGGCTAT-1	Subplate
GGATACTTCATTATGG-1	RG, Astro, OPC
GGCCTTCGTTAGCCAA-1	Subplate
GGACCTCAGGATCCGC-1	Upper Layer
GGCCAACTCTAAGTGC-1	Upper Layer
GGCCTCTGTTTCCACG-1	Upper Layer
GGACAGCCATAGCTTG-1	Interneurons1
GGAGTCTGTCAAAGGG-1	Subplate
GGCATTGTCAATCTCT-1	Upper Layer
GGACATAAGGATAAAC-1	RG, Astro, OPC
GGCATTGTCTATCGCC-1	RG, Astro, OPC
GGCCTTCGTGAAACAA-1	Upper Layer
GGCCAGTTCCGCATGA-1	Upper Layer
GGCGATACATTCCTGT-1	V-SVZ
GGACGGATCTCAATGA-1	V-SVZ
GGACATAAGATAACCC-1	V-SVZ
GGCAAGCCATGTCGCG-1	IPC
GGATGAATCTCACTAT-1	RG, Astro, OPC
GGCGGTTTCACCTGTC-1	RG, Astro, OPC
GGATGGCCAAGGTCGA-1	Deeper Layer
GGCGGTAAGTCATTGA-1	V-SVZ
GGATAACCAACTGGGA-1	Interneurons3
GGACGGATCTCACTAT-1	Deeper Layer
GGACCTCAGCCACATG-1	Upper Layer
GGACCTCAGCGGATAA-1	RG, Astro, OPC
GGAGCGATCCTAAGGT-1	Upper Layer
GGACATAAGCGAGTAA-1	Interneurons2
GGAATCTTCAAGTGAG-1	Upper Layer
GGCCTTAAGGAAGCAC-1	Deeper Layer
GGATTATGTAATAACC-1	V-SVZ
GGACGAAGTGTTGTAG-1	RG, Astro, OPC
GGATTCAGTGTGTGGT-1	Upper Layer
GGATGTAAGGACGTAA-1	Deeper Layer
GGAATCTTCGGGACCT-1	Interneurons2
GGCAAATCAGGCGAGT-1	RG, Astro, OPC
GGAGTGAGTTAGCAGC-1	Ependymal cells
GGCGGTTTCAATTGGC-1	Subplate
GGCCTTCGTGCCGCAA-1	RG, Astro, OPC
GGAGTGAGTTCAAGAT-1	Upper Layer
GGACCTCAGTAACCCG-1	Upper Layer
GGTAGGAGTTACGCAA-1	Deeper Layer
GGGTGTTGTCATTGTC-1	Interneurons1
GGGCAATAGCGCCTTT-1	Upper Layer
GGTAAGGGTTTGTGGA-1	Upper Layer
GGTAACTTCTTGTCCA-1	Interneurons3
GGGTTTGTCGAAGTAG-1	Upper Layer
GGTCAAGCACAGGATG-1	Upper Layer
GGCTCAATCTTGACCC-1	Interneurons2
GGGTTTCCAGCAACCT-1	Upper Layer
GGCTTCAAGGTTAGCT-1	IPC
GGTAACCGTATGGTGC-1	V-SVZ
GGCTGTCAGTAGCCAT-1	V-SVZ
GGCTATGTCCAAACAC-1	Upper Layer
GGTACAAAGCTTTGGG-1	RG, Astro, OPC
GGCTGAGAGCCTGTGA-1	Interneurons2
GGTCAAGCAGAATGAC-1	Interneurons3
GGCTGAGAGTTATGGC-1	Deeper Layer
GGGTCACTCATGGTGT-1	Upper Layer
GGGTTTCCATTATCCC-1	Deeper Layer
GGGTTATTCTATTGTC-1	Upper Layer
GGTCAATTCAATTACG-1	Upper Layer
GGGTGTTGTCCTAGTT-1	RG, Astro, OPC
GGTAAGGGTTCCTGAT-1	V-SVZ
GGCTATTAGCTATTAG-1	Interneurons1
GGGCATTGTTGGATCA-1	Upper Layer
GGGTTACGTACTGAAT-1	Upper Layer
GGTCAATTCCCGCAAA-1	V-SVZ
GGTAATTGTCCTAACT-1	V-SVZ
GGCTGGTTCTTAGGAC-1	Cajal-Retzius
GGGTCACTCCTTGCGT-1	Subplate
GGGATAATCTTTAAGG-1	RG, Astro, OPC
GGTACAAAGTCCTGAG-1	V-SVZ
GGCTGAGAGGCAAGTA-1	Interneurons1
GGTATTTCACAGGGAC-1	RG, Astro, OPC
GGGTTATTCTTGGACG-1	Deeper Layer
GGTACTTAGCGATAAG-1	RG, Astro, OPC
GGTAGGAGTGAAGCCT-1	Deeper Layer
GGCTCACAGTCTATGA-1	Ependymal cells
GGTAGGAGTCTAACAG-1	Upper Layer
GGGTTACGTGAGACTC-1	Microglia
GGGCATGAGTAATCCA-1	Upper Layer
GGTATGTTCGCTAAGT-1	IPC
GGGTATTTCCGGTATG-1	Upper Layer
GGCTAGTGTACCGTAA-1	V-SVZ
GGGTTACGTTGTAACG-1	Subplate
GGCTATGTCCTTGCAC-1	Ependymal cells
GGGTATTTCGCAGGCT-1	Deeper Layer
GGTATTTCAGCCAGAA-1	V-SVZ
GGCTTCAAGTAAGTGG-1	RG, Astro, OPC
GGGTGAAGTTCTTTAG-1	V-SVZ
GGGAATATCGAAGTGA-1	RG, Astro, OPC
GGTAACTTCACGCATG-1	Upper Layer
GGGTGAAGTCCTTCAG-1	Deeper Layer
GGCTGGTTCCGGCTAA-1	V-SVZ
GGTAACTTCAGGTTTA-1	Upper Layer
GGCTAGTGTTAATGAC-1	Upper Layer
GGTCAAGCATAAGTCT-1	Interneurons2
GGTAACCGTTACGCGG-1	Deeper Layer
GGTAACTTCCTTGAGG-1	Deeper Layer
GGCTCACAGGGATTAG-1	V-SVZ
GGGCGAATCATAGCCG-1	Upper Layer
GGCTAGTGTGCTCCAC-1	Deeper Layer
GGCTTCAAGTCATTAG-1	Ependymal cells
GGCTATTAGTCTTGAA-1	V-SVZ
GGCTCACAGTAACAGG-1	Deeper Layer
GGTAACTTCTACCTGC-1	Ependymal cells
GGGCAATAGCTCCTAC-1	Interneurons1
GGCTTAAGTAAGCTCA-1	Upper Layer
GGGTGAAGTAAAGCGG-1	RG, Astro, OPC
GGGATAATCATGTTTC-1	Interneurons2
GGGTTACGTATTCGTC-1	Interneurons1
GGCTCACAGCACTAAC-1	Deeper Layer
GGTAACCGTTCGCTTG-1	Deeper Layer
GGCTGTCAGACAAACG-1	IPC
GGGCAATAGTATTGGC-1	Upper Layer
GGTCAATTCCACCCTG-1	Interneurons3
GGGAATATCTCACTAT-1	Deeper Layer
GGGTTATTCGGTCATG-1	Deeper Layer
GGTATTGGTATTTGGG-1	Interneurons1
GGGCATGAGGCATGAA-1	V-SVZ
GGGTGTTGTCCTTAGT-1	V-SVZ
GGCTGTCAGTTGGGCC-1	Deeper Layer
GGCTAGTGTTATCCTA-1	V-SVZ
GGGTATTTCCGCAAGC-1	Deeper Layer
GGTAATTGTTTCCACG-1	Upper Layer
GGCTCAATCCCTGATC-1	Deeper Layer
GGGCTAACAGTTATCG-1	RG, Astro, OPC
GGTACAAAGTAACCCG-1	Interneurons3
GGTTTCTGTGCTGGTG-1	Upper Layer
GGTGTGACACCCTCAC-1	Upper Layer
GGTCCGTAGGCTAATC-1	Deeper Layer
GGTTAGCGTTAGCCAA-1	Upper Layer
GGTGAGTAGGGTTATC-1	Upper Layer
GGTGAGGTCCTGAGTG-1	Upper Layer
GGTTCCCGTGCTAGAC-1	Ependymal cells
GGTCCTGCAAAGCGCA-1	Deeper Layer
GGTGAGTAGCTATGAC-1	Deeper Layer
GGTTATGGTTAACAGT-1	Upper Layer
GGTTTCCTCCTTAATC-1	Upper Layer
GGTTTAATCTAAGTGC-1	Interneurons2
GGTGCTTCATGAAATG-1	Upper Layer
GGTTGCGGTTCCGGCT-1	V-SVZ
GGTGTGACAGTCTAAT-1	Upper Layer
GGTTTCCTCTCGCCTG-1	V-SVZ
GGTGAGTAGCACTAAC-1	Interneurons1
GGTTACTAGCCTGGTA-1	Upper Layer
GGTTATATCGGCTAGC-1	V-SVZ
GGTTGGTGTTGCACGG-1	V-SVZ
GGTTACTAGTCACGAT-1	Deeper Layer
GGTGTGACATCCTGAA-1	Upper Layer
GGTTGAGCATCTAGCA-1	Upper Layer
GGTGTGACAGGTTATT-1	Interneurons1
GGTCAGGAGCAGCTCA-1	Ependymal cells
GGTTTCTGTCAGTAAT-1	Upper Layer
GGTTAATGTAAGCTCA-1	RG, Astro, OPC
GGTCAGGAGTTGCCTC-1	Upper Layer
GGTGCTTCAATGAAGC-1	Upper Layer
GGTTAGCGTGTGAGAG-1	Interneurons3
GGTCGGTTCGAGGAAC-1	IPC
GGTCAATTCGGTCAAT-1	Upper Layer
GGTTTCCTCGGTCATG-1	Ependymal cells
GGTCTTTGTCTTTGAC-1	Deeper Layer
GGTTGCATCAGGATGA-1	Deeper Layer
GGTTTAATCCGCCTAT-1	RG, Astro, OPC
GGTGTTGTCTTAGCGG-1	Upper Layer
GGTTGACGTTTGCAGA-1	V-SVZ
GGTTATGGTGTTCCCA-1	RG, Astro, OPC
GGTTACTAGGTCGAGG-1	Subplate
GGTTAATGTCATAAGT-1	RG, Astro, OPC
GGTGAGCCAGCACGAA-1	Upper Layer
GGTCTTTGTGGATTCA-1	Interneurons3
GGTTGCGGTAATGGCC-1	Deeper Layer
GGTGATTTCTTACTCG-1	V-SVZ
GGTGAGCCAATCCTAG-1	Upper Layer
GGTGATTTCAGGAAGC-1	V-SVZ
GGTTACCCAAGGATTA-1	Upper Layer
GGTTTCCTCATCCACC-1	Interneurons2
GGTGTGACAGGATTAA-1	RG, Astro, OPC
GGTTACTAGTTATGGC-1	Interneurons2
GGTTACCCAGTCTAGC-1	V-SVZ
GGTCATTAGCTGTAAC-1	Upper Layer
GGTCCATCATCTTGAG-1	V-SVZ
GGTGCTGGTTAAGCGC-1	Upper Layer
GGTCAGGAGTTAGGCT-1	Interneurons1
GGTCTTTGTGTCCAGG-1	Upper Layer
GGTCTTTGTCCGGTTC-1	RG, Astro, OPC
GGTTATGGTGATCAGC-1	RG, Astro, OPC
GGTGCTTCATTGTGGC-1	IPC
GGTTGAGCAGCATGTC-1	V-SVZ
GGTTACTAGTAACCCG-1	V-SVZ
GGTTAATGTATTGTGG-1	Deeper Layer
GGTCCTGCAGCACGTT-1	RG, Astro, OPC
GGTGAGCCAATTTGGT-1	V-SVZ
GGTTAGCGTCCACAAA-1	Upper Layer
GGTCCATCAGAGGGAG-1	RG, Astro, OPC
GGTGAGGTCTTGATGA-1	IPC
GGTGTCCAGCTTGCTC-1	Deeper Layer
GGTTGACGTGTGTGGT-1	IPC
GGTCAGGAGTCAGGCC-1	Interneurons2
GGTCTTTGTTGCAATG-1	Deeper Layer
GGTGAGCCATTTGCTC-1	Deeper Layer
GGTGAGTAGGCCCAGT-1	Interneurons1
GGTGATTTCCTCGATC-1	RG, Astro, OPC
GGTGCTGGTACAATGT-1	Subplate
GGTTCTTGTTAATCGG-1	Deeper Layer
GGTGAGGTCTGTGCCT-1	Ependymal cells
GGTTATGGTATTGTGG-1	Interneurons3
GGTTTCTGTCCAAATG-1	RG, Astro, OPC
GGTGCTGGTCAACAAT-1	RG, Astro, OPC
GGTTACCCACCGGCTA-1	V-SVZ
GGTTGCTCAGATAGAC-1	Deeper Layer
GGTCGGTTCTCACTCA-1	V-SVZ
GGTTACTAGGTTACGT-1	Upper Layer
GGTCCTGCAACCCTCC-1	IPC
GGTCCATCATAAAGCA-1	Upper Layer
GGTGAGCCAAGGTATA-1	IPC
GGTCTTTGTAGTCAAT-1	Subplate
GGTCCGTAGTACCGCA-1	Deeper Layer
GGTCTTGAGTAACTCA-1	Ependymal cells
GGTTACTAGGGATGAC-1	Subplate
GGTCATTAGAGGAAGG-1	Deeper Layer
GGTGTGACATTGTGCA-1	Subplate
GGTTACTAGGACGTAA-1	Upper Layer
GGTTGCATCATGGTTA-1	Deeper Layer
GGTGATTTCCACAATA-1	RG, Astro, OPC
GGTGCTGGTTATAGCG-1	Deeper Layer
GGTCCTGCACCTGGTG-1	Deeper Layer
GTAGGAGGTTGCGGAT-1	Upper Layer
GTCAAACTCACATTGA-1	Upper Layer
GTAAGCAAGCTAAAGG-1	Interneurons2
GTATCGCCACATAGCC-1	Ependymal cells
GTAGTTTCATTAAAGG-1	V-SVZ
GTACTAGGTTGTAAAC-1	V-SVZ
GTATTCAAGCCTAACG-1	Upper Layer
GTATTGCAGTTAGTGC-1	Interneurons2
GTAAGGTCAACACCTA-1	Upper Layer
GTACCGGGTCGACTAA-1	Interneurons2
GTAGGCGAGTAAGTGG-1	Upper Layer
GTATTGATCTTGTCTG-1	Deeper Layer
GTCAAACTCGCGCTAA-1	Interneurons3
GTAGGAGGTTAGTGAT-1	IPC
GTATGTTCATTGTGTG-1	Upper Layer
GGTTTGTAGAATCTCA-1	Interneurons1
GTAAGCTTCATTCATC-1	Subplate
GTACAATGTTCCGGGA-1	Deeper Layer
GTACCGGGTACCAGGT-1	V-SVZ
GTACTAGGTGAAACAA-1	Deeper Layer
GTATTGCAGCCGCTAA-1	V-SVZ
GTATTCAAGCTATGAC-1	Ependymal cells
GTAGTTATCATGACCG-1	Upper Layer
GTACTAATCCAAGTGT-1	RG, Astro, OPC
GTAGGTGCAAAGCTCC-1	V-SVZ
GTCAAACTCCGCCTCA-1	Deeper Layer
GTATTGTCATTAAAGG-1	Upper Layer
GTAGGCGAGTGCACGC-1	Upper Layer
GGTTTGTAGAGAGCCG-1	Interneurons2
GTACGTAGTAGCTAAT-1	Subplate
GTATTGATCTCCTCTT-1	Subplate
GTAGCCATCCAAGTTA-1	Upper Layer
GGTTTGTAGGAGGTTA-1	Deeper Layer
GTACCTTGTTGTTCAC-1	IPC
GTATTCAAGTCACTAA-1	IPC
GTAGCCATCCTTAGGG-1	Deeper Layer
GTACTTCGTTCGCTCA-1	IPC
GTAAGGTCACCAAAGG-1	Deeper Layer
GTAGGCGAGCGAGCGA-1	Upper Layer
GTACTTAAGAGAGGCT-1	Upper Layer
GTAGCTGTCTTGAGCG-1	IPC
GTACTTCGTCGTAATG-1	Upper Layer
GTAAGGTCACCTCAGG-1	IPC
GTAAGCTTCGCAGGCT-1	Cajal-Retzius
GTACGTAGTCAAGTAT-1	Ependymal cells
GTAGGTGCACAAAGCG-1	Interneurons2
GTAGGTGCAAGTTATC-1	Ependymal cells
GTAGTTATCACAGCGC-1	Ependymal cells
GTACTAATCTGGCATG-1	Upper Layer
GTAATAGCACGAATCC-1	Deeper Layer
GTAAGCAAGTGAGCAA-1	Upper Layer
GTAGCCATCCCATAGG-1	IPC
GTAAAGCCATTGTCCT-1	Ependymal cells
GTACTAATCATGAGCT-1	Upper Layer
GTAAGCGCAACTCGCG-1	Interneurons2
GTAAGGTCACAGACTC-1	Ependymal cells
GTAGCCATCCCTCATA-1	Interneurons1
GTAGGCGAGAGAGCCG-1	IPC
GTATGTTCACCTAAGC-1	V-SVZ
GTAGTTATCATAACGC-1	Deeper Layer
GTACTGGTCATTGTCT-1	V-SVZ
GTAGGATCAAACATAG-1	V-SVZ
GTAAGGTCATCCCGCT-1	Interneurons1
GTAGCCATCCTTCGTA-1	RG, Astro, OPC
GTATGTTCAAAGCCTC-1	V-SVZ
GTAGGATCAACTGGCT-1	V-SVZ
GTATTCAAGGCATTAC-1	Upper Layer
GTAAGGTCACCCTCAC-1	Subplate
GTACTTAAGGTAGCTT-1	Interneurons1
GTATGTGGTGGATTGC-1	Deeper Layer
GTACTTCGTAGCCTAA-1	Subplate
GTATCGCCAATAACCT-1	Interneurons3
GTACCTTGTCATAAGT-1	Interneurons3
GTAGTTATCTTGCATT-1	V-SVZ
GTAGTTTCAATTAGCT-1	V-SVZ
GTATCGCCATTGTGTG-1	Subplate
GTAGTTATCATGTCAA-1	Upper Layer
GTAGTTTCATCATGGC-1	Interneurons2
GTAGCCATCAGGTTTA-1	Interneurons2
GTAGCCATCCCGTTAC-1	Ependymal cells
GGTTTCTGTTAGACCA-1	Deeper Layer
GTACAATGTCGTTATC-1	RG, Astro, OPC
GTACTTAAGCAAGGTA-1	Deeper Layer
GTAGGTGCAATAATGG-1	Upper Layer
GTATTGATCGCAATCG-1	Upper Layer
GTACCGGGTATTTGCC-1	Upper Layer
GTAGCGCTCATAGCCG-1	Deeper Layer
GTACAATGTTTGGTTC-1	Deeper Layer
GTCATGCCATTGTGGC-1	Ependymal cells
GTCAGGCTCCTGAATA-1	Interneurons3
GTCCGTAAGCTGAGGG-1	V-SVZ
GTCTTTGTCAATGACC-1	Interneurons1
GTCATGCCATGTTTGG-1	Interneurons1
GTCCAAGTCGGGCCAT-1	Deeper Layer
GTGAGGAGTACCCACC-1	Upper Layer
GTCATTAAGCGGATTT-1	Subplate
GTCTAACAGTCTTGAA-1	Interneurons1
GTCTAATCACGGTTTA-1	RG, Astro, OPC
GTCGAGGAGCAAGACA-1	V-SVZ
GTGAATCTCCCTGGAA-1	Deeper Layer
GTGAACAAGCAATAGG-1	Upper Layer
GTCTTTGTCTGTGCAG-1	RG, Astro, OPC
GTCCAAGTCTGCAAAC-1	Deeper Layer
GTCGCAATCCTGATTT-1	Upper Layer
GTCATCCTCAAACTCA-1	Upper Layer
GTGATCAGTGCTGGTG-1	RG, Astro, OPC
GTCTATCGTTGTCCAT-1	Ependymal cells
GTGAATCTCATAATCG-1	RG, Astro, OPC
GTCATTAAGCATTTCT-1	Upper Layer
GTGAATCTCGTTATAG-1	Deeper Layer
GTCTTGCTCGCTCCAT-1	Upper Layer
GTCTAGCCAGGGAGCT-1	IPC
GTCTATCGTAACGTGC-1	Ependymal cells
GTCTTGCTCCGCAAGC-1	Upper Layer
GTCTTTAGTCTTGCTG-1	Upper Layer
GTCATTAAGCTCATAA-1	RG, Astro, OPC
GTGCATTAGCTGTCAG-1	Upper Layer
GTCAATATCCACCCTG-1	RG, Astro, OPC
GTCGGTTCATTGTTGG-1	Upper Layer
GTGAACAAGGTCCAAT-1	Interneurons1
GTCTTTAGTCATAAGT-1	Upper Layer
GTGATCAGTCAGGCCA-1	Cajal-Retzius
GTCTAATCATGTTGTG-1	Upper Layer
GTCCTCCCAGGACACA-1	Interneurons1
GTGATGAAGGGACGCA-1	Upper Layer
GTCCAGGGTGTCCAGG-1	RG, Astro, OPC
GTGATGAAGCTGCACA-1	Deeper Layer
GTGCAAGCAATGCCCG-1	Interneurons2
GTCTATCGTAAGCTCA-1	V-SVZ
GTCGAAGCAGCTCAAC-1	Deeper Layer
GTCGAGGAGGGCTTTG-1	Interneurons2
GTCGGTTCAGTTTGGC-1	V-SVZ
GTCTTTAGTGGATGTC-1	Interneurons2
GTGATGAAGTCACTAA-1	Interneurons1
GTGCACGGTAAAGCGG-1	Ependymal cells
GTCATCACACGGTTTA-1	V-SVZ
GTGCATTAGGTCATTA-1	Deeper Layer
GTCAATATCTCACAAA-1	Upper Layer
GTCGGTTCAAGGTGCA-1	Deeper Layer
GTCCGTAAGAGAAGGG-1	IPC
GTCTAATCATTGTCCT-1	Deeper Layer
GTCAATATCAATTACG-1	Interneurons2
GTCTTTGTCTTAAGTG-1	IPC
GTGATCAGTATGGTGC-1	Deeper Layer
GTCAATATCGTTAACA-1	Subplate
GTCCTCAGTCATAACG-1	Upper Layer
GTGAATCTCGGCTAGC-1	Subplate
GTCCTCAGTTATTGCC-1	Deeper Layer
GTGCACGGTTAAGCGC-1	Upper Layer
GTCCATTGTAGTTAAC-1	Upper Layer
GTCGAAGCACATTGCA-1	Subplate
GTCATGCCAAGGTCCT-1	V-SVZ
GTCATTAAGGATGATG-1	V-SVZ
GTCCTAGAGTGGACAA-1	Deeper Layer
GTCTTTGTCGTTATCT-1	Ependymal cells
GTGCAAGCAAGTGAAC-1	Interneurons3
GTCCTCAGTGGAAGGC-1	V-SVZ
GTCTATCGTTCACTGT-1	V-SVZ
GTGATGAAGGAATAAC-1	Interneurons2
GTGAATCTCGCTTGCT-1	Cajal-Retzius
GTCGAGGAGGACTTAC-1	Upper Layer
GTCTTTAGTATGTGGC-1	Upper Layer
GTCTATCGTGGTTAGC-1	Deeper Layer
GTCAATATCGTACCGA-1	Upper Layer
GTGCATTAGCGAGCGA-1	Upper Layer
GTGATGAAGCATTTCT-1	Deeper Layer
GTCCGTAAGCTTAGTA-1	Deeper Layer
GTGATCAGTCGTAAAT-1	RG, Astro, OPC
GTCAGGCTCAAGGACA-1	RG, Astro, OPC
GTCGCAATCCCGAACA-1	V-SVZ
GTCGAAGCAACAACAA-1	Upper Layer
GTCGAGGAGTCATGCG-1	V-SVZ
GTGAATCTCGTAACGT-1	V-SVZ
GTCCGTAAGCCTGTTC-1	RG, Astro, OPC
GTCAATATCGGTACGC-1	Upper Layer
GTCTATCGTTGGTTGA-1	Interneurons1
GTCCTCAGTGCATTTC-1	Upper Layer
GTCAATATCTTTAGGA-1	Deeper Layer
GTCGAGGAGACAAGTG-1	Interneurons2
GTGATCAGTTTCAGGA-1	Interneurons2
GTCCAGGGTACTGATG-1	V-SVZ
GTGTCCAAGCTAAAGG-1	Deeper Layer
GTTCACCTCAGGATGA-1	Upper Layer
GTGTTACAGTAAACCC-1	RG, Astro, OPC
GTGTCCAAGTTGGCCA-1	Ependymal cells
GTGCCTTTCCGTCCAT-1	Deeper Layer
GTGGTTAGTGCATTAG-1	Upper Layer
GTGCTGGGTGTCACGG-1	Interneurons1
GTGGCTTCAACTAGCC-1	IPC
GTTACTAAGGTCGATT-1	Subplate
GTGTGAGCACTGGCTG-1	Upper Layer
GTTAAGTGTTCGCTCA-1	Ependymal cells
GTGTTCCTCCTTAGGG-1	RG, Astro, OPC
GTGCCTTTCTCACTCA-1	V-SVZ
GTGGCTTCAAACGGGC-1	V-SVZ
GTGGCTTCAATGCGCT-1	Interneurons1
GTTAACGGTTGAGGTC-1	V-SVZ
GTGTTCCTCTAAGTGC-1	Deeper Layer
GTGTGTTAGGAACACA-1	Upper Layer
GTGTGCGGTTGGCCGA-1	IPC
GTGTGAGCAACAGGAT-1	Interneurons2
GTGTGTTAGGCAACAA-1	Deeper Layer
GTTAGACTCCCTCAAC-1	Interneurons2
GTGGTTAGTTGGATAT-1	Subplate
GTGCTCCGTCAAAGAA-1	Upper Layer
GTGTGTTAGTTGGCCA-1	IPC
GTGCTTACAGGTTCAC-1	Upper Layer
GTGCGGTTCCGCAACA-1	Upper Layer
GTTAACCAGCAAGATG-1	Microglia
GTGCCTTTCTTGTCTG-1	V-SVZ
GTGCTGATCCCGAACA-1	Deeper Layer
GTGGCTTCAATTGACT-1	Deeper Layer
GTTAACGGTCACAGCG-1	Deeper Layer
GTGCTCAAGGCAACAA-1	Deeper Layer
GTTCACCTCAGTGAAG-1	Deeper Layer
GTGCTGGGTCTCAGCC-1	RG, Astro, OPC
GTTACTCGTCTAACCT-1	Upper Layer
GTGTGTTAGGCCCAGT-1	Interneurons2
GTGCGGTTCCTTTACG-1	Upper Layer
GTGCTGATCAATGTGC-1	RG, Astro, OPC
GTGGATGCACTGGCCA-1	Deeper Layer
GTTAACCAGCTGGACC-1	Ependymal cells
GTGGCTTCAAGACTCC-1	Deeper Layer
GTGTTACAGGAATAAC-1	Ependymal cells
GTTACGTAGGCTACAT-1	V-SVZ
GTTCACCTCAAATCGC-1	V-SVZ
GTTAACGGTACCCACC-1	V-SVZ
GTTAAGTGTGAGACTC-1	Interneurons2
GTGCTTACACTAAGAA-1	Subplate
GTGGCTTCATCAATCG-1	Microglia
GTTAGGCGTAGCTGCG-1	V-SVZ
GTGCGCAGTGAGAAAC-1	Upper Layer
GTGCTCCGTACCGGAT-1	Ependymal cells
GTGGCTTCAGGAACAT-1	Deeper Layer
GTGTTACAGCGTGCAC-1	V-SVZ
GTTAGGCGTGAGAAAC-1	Interneurons1
GTGTAACTCGAGGAGT-1	Interneurons2
GTGGATGCAACTAGGG-1	Deeper Layer
GTTACCTGTTAGGATT-1	Subplate
GTGTAACTCTGCAACG-1	V-SVZ
GTTAGGCGTCGACTAA-1	Interneurons1
GTGTTACAGTGACCTG-1	Interneurons1
GTGGACACAGGTTCAC-1	RG, Astro, OPC
GTGCCTTTCTTGAGCG-1	Deeper Layer
GTGCCTTTCGAAGTGA-1	Upper Layer
GTGGCTTCACTAGCGT-1	Upper Layer
GTTAACCAGTGTGATC-1	Upper Layer
GTTAGACTCTCACTAT-1	RG, Astro, OPC
GTGTGAGCACTTAACG-1	Deeper Layer
GTGCTTCTCCACAATA-1	Deeper Layer
GTGCCTTTCACTCAAA-1	Ependymal cells
GTTAGGCGTTCACTGT-1	Upper Layer
GTGGCTTCAGTAGGAT-1	Upper Layer
GTGCTCAAGACTAAGG-1	V-SVZ
GTGCTGATCCAGCACA-1	Interneurons1
GTTAAGTGTGTGTGGT-1	Interneurons1
GTTAAGTGTGCGCATG-1	Deeper Layer
GTGCTCCGTTTGACCT-1	RG, Astro, OPC
GTTAATGTCGTCATTT-1	Upper Layer
GTGTTACAGTCATGCG-1	RG, Astro, OPC
GTTAAGTGTGGGAACA-1	Upper Layer
GTTAAGTGTTAGTTGG-1	Upper Layer
GTGTGCGGTAGCAGCT-1	Interneurons2
GTTAACGGTTTGGGTA-1	RG, Astro, OPC
GTGCTGATCATCCACC-1	Deeper Layer
GTGCTTCTCGTTAGCG-1	Subplate
GTTAACGGTGCATTTC-1	Upper Layer
GTGCGGTTCAAGCTTA-1	Interneurons3
GTTTAGCAGGACCTTG-1	Interneurons2
GTTGTGAGTGATGATT-1	Upper Layer
GTTGGCGGTACTGAAT-1	Interneurons3
GTTGCCCGTTAACAGT-1	Upper Layer
GTTCTTGTCACCGGTA-1	Deeper Layer
GTTCGCTTCTTGCATT-1	Deeper Layer
GTTGCCCGTGCTAGCG-1	Upper Layer
GTTCACCTCATGTGGT-1	RG, Astro, OPC
GTTCCTGGTCTAGCTT-1	Interneurons1
TAACAAGCAGGGAGCT-1	V-SVZ
GTTTCTAGTGTGCACG-1	V-SVZ
TAAACAGCAGACAAAC-1	Cajal-Retzius
GTTCCTTCAAACATAG-1	Upper Layer
TAACCAGGTTATCCTA-1	Deeper Layer
GTTTGTCGTACGTTTC-1	RG, Astro, OPC
GTTGTTGCAAGTGTTT-1	V-SVZ
GTTCTTAGTTTACTTG-1	V-SVZ
GTTTATCTCGCTCCAT-1	Upper Layer
GTTGGCGGTAGGTTAT-1	Ependymal cells
GTTCTCATCTTAGTCT-1	Upper Layer
GTTGTTGCAATATACC-1	RG, Astro, OPC
GTTCCTTCACTTCACT-1	Deeper Layer
GTTCGCGCAATAACGA-1	Upper Layer
GTTCTTAGTTGTCCAT-1	Upper Layer
GTTTAGCAGGTGCGGA-1	V-SVZ
GTTTATCTCACGTTAA-1	RG, Astro, OPC
GTTTACCGTCAGGCCA-1	V-SVZ
GTTTCAGCAAATTGCT-1	V-SVZ
TAACCAGGTCTAGCTT-1	V-SVZ
TAACAAGCATCCCGCT-1	Deeper Layer
GTTCTTGTCCGTCCAT-1	V-SVZ
GTTTGCTGTTCCTGAT-1	Upper Layer
TAAACAGCAGGCATCT-1	Ependymal cells
GTTCTCATCGTTTCTG-1	Ependymal cells
TAACAAGCACACTAAT-1	Upper Layer
GTTCCCAGTTACAAAC-1	V-SVZ
GTTGTGAGTAATAACC-1	Interneurons2
GTTTAGCAGTAGCTTA-1	Deeper Layer
GTTTGTAAGTTGTCCC-1	Interneurons2
GTTGTGAGTTTACTTG-1	Upper Layer
GTTTCTAGTCCTAAGA-1	RG, Astro, OPC
GTTCGCGCAGCAATAA-1	RG, Astro, OPC
GTTGCATAGACTATTG-1	RG, Astro, OPC
GTTGGCCAGGTACCGC-1	Interneurons2
GTTCACCTCGTTAACA-1	Ependymal cells
GTTGGCCAGACTTACA-1	Deeper Layer
GTTTACCGTAGGTTTG-1	Deeper Layer
GTTGTGAGTGTTAAAC-1	V-SVZ
GTTCTTGTCTAATCCT-1	Deeper Layer
GTTCGCGCAAGACTCC-1	Subplate
GTTCCTTCAGTAGGTG-1	Interneurons1
GTTCCTGGTCTTTATG-1	Upper Layer
GTTCATTTCCACAATA-1	Upper Layer
TAACCAGGTATTGGTG-1	Upper Layer
GTTGCTGAGTGAACGA-1	V-SVZ
GTTCTTAGTCATCCTG-1	Upper Layer
TAAACAGCAAATTCGT-1	IPC
GTTCTCATCACCTGTC-1	Upper Layer
GTTGTGAGTAGGTGTC-1	Deeper Layer
GTTCGCGCATCTTGAG-1	Upper Layer
GTTCTCATCGCTTGCT-1	V-SVZ
GTTGGCGGTTCGCTTG-1	Upper Layer
GTTGCGGGTAATGACT-1	Deeper Layer
GTTTAGCAGTCCTTCA-1	Upper Layer
GTTCGCGCAATAAGCA-1	RG, Astro, OPC
TAACAAGCAGTTTGTG-1	V-SVZ
GTTCTTGTCAGAAACG-1	Upper Layer
GTTTCCTCACCTATAG-1	Upper Layer
GTTCCCAGTTAGCTGA-1	Interneurons1
GTTTGTTTCGATCAGT-1	RG, Astro, OPC
GTTCTTAGTTGCTTCG-1	Interneurons2
GTTCGCTTCATGCATA-1	Upper Layer
GTTCTTAGTGAGAAAC-1	Interneurons2
GTTGCGGGTAGGTTAT-1	Upper Layer
GTTGTGAGTTTAGCGA-1	Interneurons1
GTTCATTTCAAGTGAG-1	Interneurons1
GTTTGTCGTGTCCTGC-1	V-SVZ
GTTGGAGCAGTAATAG-1	V-SVZ
GTTTAGCAGGCTAATC-1	Deeper Layer
GTTTCAGCATCTTGAG-1	V-SVZ
GTTGGAGCACCTCGCT-1	RG, Astro, OPC
GTTCCCAGTCAGGCAT-1	Interneurons1
GTTCTTAGTATGGTGC-1	Upper Layer
GTTCTTAGTTACGCGG-1	IPC
GTTGGCCAGCGCTAAT-1	V-SVZ
GTTCGCTTCCTAAGAC-1	Upper Layer
GTTCATTTCACTCAAA-1	V-SVZ
GTTTACCGTTGGATCA-1	V-SVZ
TAACCAGGTGCTCACC-1	Upper Layer
TACCGTTGTTGTGACA-1	Deeper Layer
TACGTAATCATAACTG-1	Upper Layer
TACGGATTCTCTAGCC-1	Ependymal cells
TACAGGTTCTTTAAGG-1	Subplate
TACCTGCTCCTTAATC-1	Interneurons3
TACGTAATCAATGAGG-1	Deeper Layer
TACGGTTAGGTTACAC-1	Ependymal cells
TACCCGGCAATAACGA-1	V-SVZ
TAATGCATCAAGCTAC-1	Interneurons1
TAATCCGCAGGCATCT-1	Upper Layer
TACAGCTAGCGGGCAA-1	V-SVZ
TAAGGACCAGAGGCTA-1	IPC
TAACCGGTCAGTTCCC-1	Deeper Layer
TACCAAATCAATGTGC-1	Upper Layer
TACCAGGTCGCTAGAT-1	RG, Astro, OPC
TACCTTAGTAAGCTTG-1	RG, Astro, OPC
TAATGGTGTGCATTTC-1	IPC
TACGTTAAGTTCCCAC-1	Deeper Layer
TAATGCATCCGTGACA-1	Deeper Layer
TACCTCATCATAACGC-1	RG, Astro, OPC
TAAGGACCATAATGAG-1	Ependymal cells
TAAGGCTTCATTGTCT-1	Upper Layer
TAATCCGCATGCTATG-1	RG, Astro, OPC
TAATCCGCACCATATG-1	V-SVZ
TACCCGGCATGAAATG-1	Interneurons1
TAAGCTATCGCGACAC-1	Deeper Layer
TAAGCTGGTCCTTAGT-1	Ependymal cells
TAATCCGCACTAGCGT-1	Interneurons1
TACCTCATCTTAGCCC-1	Ependymal cells
TACCTTAGTTGTTGGA-1	Interneurons2
TACCGCAAGGAAGCTA-1	Deeper Layer
TAACCGGTCCTAAGTA-1	Upper Layer
TACAGGTTCGAAGTAG-1	RG, Astro, OPC
TACCTTTAGTCCTGAG-1	Ependymal cells
TACAACATCGTTATAG-1	Interneurons1
TAATGGTGTTATAGCG-1	V-SVZ
TAATGGTGTTGCGTAA-1	Deeper Layer
TACAACATCCCTTGCG-1	Deeper Layer
TACCGCAAGGTCATTA-1	Upper Layer
TACGCTTGTCATTGAG-1	Interneurons3
TAATCCGCAGGTTAAA-1	Subplate
TACGTAATCGAAGTGA-1	RG, Astro, OPC
TACGGTTAGGAAACTG-1	Deeper Layer
TAATGCATCATTCATC-1	Interneurons2
TAACCAGGTTTCCGGC-1	Deeper Layer
TACAGGTTCACCTGTC-1	Upper Layer
TACCAGGTCTTGCATT-1	Interneurons2
TAATGCATCAATGACC-1	Interneurons2
TACCGAAGTATACTGG-1	Deeper Layer
TACCTCATCAACCAAC-1	Deeper Layer
TACGCTTGTTTGTCTA-1	RG, Astro, OPC
TACCAGGTCATGTGGT-1	Upper Layer
TACGTACAGCCTAATA-1	IPC
TACCTGCTCAGCATTA-1	Upper Layer
TACCTCATCATCCACC-1	Upper Layer
TACAGCTAGCATGCAT-1	Interneurons1
TACGTTAAGGAAGCTA-1	Deeper Layer
TAAGTGCTCAGCACGC-1	Upper Layer
TAATGGACAATAATCC-1	Interneurons1
TAATCCGCAATTGCGC-1	Subplate
TACGTAATCTAACCTT-1	V-SVZ
TACCCGGCAGCAAATA-1	Upper Layer
TACGCTTGTTTGCTGT-1	Ependymal cells
TAAGTGCTCGAAGTGA-1	Interneurons2
TAAGGCTTCAGGATGA-1	Upper Layer
TAATTGCCACTAAGAA-1	Subplate
TACAATGTCCTAGTTT-1	Deeper Layer
TACCAGGTCCCGCATT-1	Interneurons2
TACAAGCTCTCACATT-1	V-SVZ
TAATCACCAATTAAGG-1	Upper Layer
TACCTGCTCATAATCG-1	Upper Layer
TACCGAAGTTGGATCA-1	Interneurons1
TACGGATTCTCAATGA-1	Upper Layer
TAAGGACCATGAGCAG-1	Deeper Layer
TAATTGCCATTAGCCA-1	Subplate
TACGTTAAGACTAAGG-1	Ependymal cells
TACAATGTCTGTAAGC-1	Interneurons1
TACGCTTGTTTGTGGA-1	IPC
TAAGCCAGTCACGAAC-1	Upper Layer
TACCTTAGTTCGCTCA-1	Deeper Layer
TACGTAATCTCACATT-1	RG, Astro, OPC
TACCTGCTCTAAGTCA-1	Deeper Layer
TAAGCCTAGTACTGGT-1	RG, Astro, OPC
TAAGCCTAGTTAGGCT-1	Upper Layer
TAAGCTATCCAAGTGT-1	V-SVZ
TACCCGGCATTGTGAT-1	Upper Layer
TAAGCCTAGTCCTTCA-1	Deeper Layer
TACCGAAGTCAATACG-1	Ependymal cells
TAATGGACATTGTCAG-1	Upper Layer
TACGGATTCATCCTAT-1	IPC
TACAACATCATGTCAA-1	Deeper Layer
TAGGCTGTCCTAAGTA-1	RG, Astro, OPC
TAGCCTGAGCTGTAAC-1	Upper Layer
TAGTGAGAGTACCGCA-1	Subplate
TAGGCTGTCCCTGGAA-1	RG, Astro, OPC
TAGCGCGGTAATTAGC-1	IPC
TAGGCTGTCCTGGTCT-1	RG, Astro, OPC
TAGCGGACATGACTAT-1	Interneurons1
TAGGAGGGTAGTCAAT-1	Upper Layer
TAGCCGGGTGCATCGG-1	Upper Layer
TACTGCACATTCCTGT-1	Deeper Layer
TAGGTGCGTTAGGTTG-1	Upper Layer
TAGGAGTCAGGCGATA-1	RG, Astro, OPC
TAGCCTTGTAAGCTTG-1	RG, Astro, OPC
TAGGGTTTCCACCTTA-1	Interneurons2
TACTCGCTCAGTATTG-1	Interneurons1
TAGCAGGCATGACTAT-1	V-SVZ
TAGCCTTGTGACCTGG-1	V-SVZ
TAGGCTTAGCGCCTTT-1	RG, Astro, OPC
TACTTGTTCCTGAATA-1	V-SVZ
TAGCTAATCTGTGCCT-1	IPC
TAGCTAGGTGCTTACT-1	Subplate
TAGGTTATCAATGAGG-1	RG, Astro, OPC
TAGCGGACATGGCCCA-1	Deeper Layer
TAGTAAGCAGCCAGTT-1	Interneurons1
TAGCATATCTTGCAGG-1	Deeper Layer
TACTAAGTCATTTGTC-1	Ependymal cells
TAGGTGCGTAATGGAA-1	Interneurons3
TAGTGTGGTCAGGCCA-1	Deeper Layer
TAGCGGACACCTCGCT-1	Deeper Layer
TAGGCTGTCCCGTTGT-1	V-SVZ
TAGGCTGTCCACCTGT-1	V-SVZ
TAGCAGGCAGAAATTG-1	Deeper Layer
TAGGAACCAAGGTCCT-1	Interneurons2
TAGAGCCGTCGCAAAC-1	V-SVZ
TACTGGCCAGGTCCTG-1	Deeper Layer
TAGGAGTCAGGAACTG-1	Deeper Layer
TACTCGCTCCGGCTAA-1	Interneurons1
TAGTGTGGTTACATCC-1	Upper Layer
TAGGGTTTCCCTGGAA-1	Upper Layer
TAGAGCCGTCCTTTAA-1	Subplate
TAGGAGGGTAGTAAGA-1	Deeper Layer
TAGCTAGGTTCATCTA-1	V-SVZ
TAGACCAGTCTTTGAC-1	Deeper Layer
TACTGACAGTTTGGGT-1	Interneurons2
TAGACCAGTGCCGCAA-1	V-SVZ
TACTAAGTCGCTCCAT-1	Deeper Layer
TAGCTTAAGGAAGCTA-1	Ependymal cells
TACTCGCTCCATTACT-1	V-SVZ
TAGCGGCTCGGTCATG-1	Upper Layer
TAGGTGCGTTAGGTGC-1	Upper Layer
TAGGGTTTCACAAGCT-1	Interneurons2
TAGGAACCACGTGCTG-1	Upper Layer
TAGCATATCAATCTAG-1	Upper Layer
TAGTGGCGTACTTAGG-1	Deeper Layer
TAGGAGTCAGCTTAAT-1	Subplate
TAGGAACCAGACAAAC-1	V-SVZ
TAGCGGACAAGGAATC-1	Deeper Layer
TAGTGGCGTGCTGGTG-1	Deeper Layer
TAGCCTGAGCACGATT-1	Deeper Layer
TAGGAGTCAGTAAAGC-1	Interneurons1
TAGTGTGGTTTACTTG-1	Ependymal cells
TACTCAAAGGAACGGT-1	Upper Layer
TACTCGCTCTAATCAG-1	Upper Layer
TACTGCACAACCGCCA-1	IPC
TAGACCAGTTGGTGAC-1	Upper Layer
TACTGGCCATTTGCTC-1	Interneurons1
TAGAGCCGTACGATTG-1	Upper Layer
TAGTGAGAGGTACCGC-1	V-SVZ
TAGGCTTAGGAACACA-1	Interneurons2
TAGTGAGAGCTAGAAG-1	Upper Layer
TAGCTTAAGTTTGGGT-1	Upper Layer
TAGGAGTCAGGCTAAG-1	Interneurons2
TAGTGAGAGCAGGTTT-1	RG, Astro, OPC
TACTCGCTCAAGTGTC-1	Interneurons1
TACTAAGTCAAGCCTG-1	Interneurons2
TAGCCTTGTCCTTAGT-1	V-SVZ
TAGGAGTCAAGTTATC-1	Upper Layer
TAGCAGGCATGTCAAT-1	Deeper Layer
TAGCCTCTCGCGCTAA-1	Upper Layer
TACTTCGTCGATTTAG-1	Deeper Layer
TAGCGCGGTACGCGCA-1	Deeper Layer
TAGTGTGGTGTGCACG-1	V-SVZ
TAGCCTGAGCTTACTT-1	Subplate
TAGGCTTAGAGAGGCT-1	Ependymal cells
TAGGCTTAGCTCGCTT-1	Interneurons2
TAGTACGGTGGAAACG-1	Subplate
TAGTAACGTCGTTACT-1	V-SVZ
TAGCTAATCTCACAAA-1	V-SVZ
TAGCTAGGTGTGTGGT-1	Microglia
TAGCGCGGTACGGTAC-1	Interneurons2
TACTGAGGTAGGTTGC-1	Deeper Layer
TAGCGCGGTCGCATAA-1	RG, Astro, OPC
TATGGTCAGTTAACCA-1	Subplate
TATAGCTCATCCCGCT-1	Upper Layer
TATCGCACATCCATCT-1	V-SVZ
TAGTTGTCAGGTTCAC-1	Upper Layer
TATCACAAGCCTGTTC-1	Deeper Layer
TATGAAGCACCTGGTG-1	RG, Astro, OPC
TATGCATCAGCAGGTA-1	RG, Astro, OPC
TATGAAGCAGTGAACG-1	Upper Layer
TATGTGATCCCTGGTT-1	Upper Layer
TATCACGCAGCTAACC-1	Interneurons1
TATCACGCATTAGGTT-1	Upper Layer
TATGGCCCACAATTAC-1	RG, Astro, OPC
TATCCGGAGGTCGATT-1	Deeper Layer
TATGGTCAGGAGCATA-1	RG, Astro, OPC
TATAACCCATAGACTT-1	V-SVZ
TATGGTCAGTCATGCG-1	V-SVZ
TATATCCTCGTTAGCG-1	Deeper Layer
TCAAACCAGGCGCATC-1	Deeper Layer
TATGGTCAGGGTTAGA-1	Subplate
TCAAGACTCCTCAGCT-1	Upper Layer
TATTGACCAGTAGCCT-1	Interneurons2
TATCACAAGGCCCAGT-1	Upper Layer
TATGCATCAGTATGTT-1	RG, Astro, OPC
TATGACATCAGCACCA-1	Deeper Layer
TATAGCCAGGCTTAAC-1	Upper Layer
TATTCGTTCCCTGACT-1	Upper Layer
TATGAAGCATCGCTTT-1	Interneurons2
TATCGAGGTTAGCAGC-1	Interneurons1
TATCGCGAGGCAAGTA-1	RG, Astro, OPC
TATTTGGAGCCACATG-1	IPC
TCAAGACTCTGCAACG-1	V-SVZ
TATGGATGTGGATTAT-1	Deeper Layer
TATGACTCACTTACAG-1	Upper Layer
TATTTGCTCGATTCTT-1	Upper Layer
TATTAGCCAACACCTA-1	V-SVZ
TATTTGCTCTAGCTTT-1	Deeper Layer
TATGAAGCAATCGCAC-1	V-SVZ
TAGTTGTCAATCGCAC-1	Interneurons1
TATCGCACATTGTGAT-1	Upper Layer
TATCACAAGCAGGCCT-1	Interneurons1
TATGGATGTGAACAAA-1	Upper Layer
TATCGCACAGGTTATT-1	Interneurons2
TCAAGACTCCGCATGA-1	Upper Layer
TCAAACCAGTAAGAAC-1	Interneurons1
TATGGATGTAAGCTTG-1	Deeper Layer
TATCACAAGCCGCTAA-1	V-SVZ
TATAGCTCAAGGTGGC-1	Interneurons1
TATGGGCGTCACTCGC-1	Subplate
TCAAGACTCGACCTGA-1	Upper Layer
TATCCAGCAGTAGGAT-1	Upper Layer
TATCGCGAGATAGACG-1	Upper Layer
TATAGGTGTCCGCTGT-1	RG, Astro, OPC
TATGAAGCATCAATCG-1	Upper Layer
TATAGCCAGTGATTCA-1	Upper Layer
TATTCGTTCTCAATAG-1	Upper Layer
TATAACCCAAATTCGT-1	Upper Layer
TATGGTCAGCGAGCGA-1	Upper Layer
TATTTGGAGGCTACTG-1	IPC
TATGGTCAGAACAAGT-1	RG, Astro, OPC
TATGCATCAAAGGCCA-1	Deeper Layer
TATTTGGAGTACTGGT-1	Upper Layer
TATAGCTCAAATACCT-1	Upper Layer
TATAGCTCAATCTCTC-1	Subplate
TATCGCACAGTACCGT-1	RG, Astro, OPC
TATTTGGAGTCAGTAC-1	Interneurons2
TATGACTCAGAGAGCC-1	Interneurons1
TATCACGCAGGCCAAA-1	V-SVZ
TATATCCTCGTTTCCA-1	IPC
TCAAGAACAAAGGCCA-1	Deeper Layer
TATGGCCCAGGGAGCT-1	Deeper Layer
TATTGACCATCATGGC-1	Upper Layer
TATGCATCACAACAAA-1	Interneurons3
TAGTTGTCACCTAAGC-1	Ependymal cells
TCAAGAACATTAAGTC-1	Deeper Layer
TATGGGCGTCACGGAT-1	Deeper Layer
TATGGATGTCTAACCT-1	Deeper Layer
TATGACATCCAGGGAG-1	Deeper Layer
TATGGTCAGGCATGAA-1	Deeper Layer
TATTTGGAGAAGGTGC-1	Interneurons2
TATTCGTTCTCCTCTT-1	RG, Astro, OPC
TATCGCGAGGTCCAAT-1	Upper Layer
TATCGAGGTTTGAGGC-1	IPC
TATTAGCCATAAGTCT-1	Upper Layer
TATGGCCCATGAAGTA-1	Upper Layer
TCAAGACTCATGTGGT-1	Upper Layer
TAGTTGTCATCCGTAA-1	Upper Layer
TATGAAGCAGTAGGAT-1	Upper Layer
TCATAACCACGGTTTA-1	Deeper Layer
TCCATGCTCGGCCATA-1	Interneurons2
TCCGGTAAGTAGGATG-1	V-SVZ
TCATCCATCATAGCCG-1	RG, Astro, OPC
TCATAACCACAGACTC-1	V-SVZ
TCATGAGGTGCTGGTG-1	IPC
TCACTGACATAAAGCA-1	V-SVZ
TCAGCAAGTCAACAAT-1	Upper Layer
TCAGCGATCAGCACGC-1	Deeper Layer
TCATTGCGTCAAGTAT-1	Upper Layer
TCACATAAGTTGGGCC-1	Subplate
TCCATATTCCTTCAAT-1	V-SVZ
TCAAGCTAGTTCCCAC-1	Upper Layer
TCCGCCATCGGGCCAT-1	Interneurons1
TCCCGGACAGCAATAA-1	Ependymal cells
TCAGTGAGTCCAAGAC-1	Deeper Layer
TCAGGTCCAATAGCAA-1	RG, Astro, OPC
TCATACTTCGTTCACC-1	Upper Layer
TCATGTTTCCCGCATT-1	Upper Layer
TCAGGTTAGCTCAAAC-1	Interneurons2
TCACATAAGGGATGAC-1	V-SVZ
TCACGGATCCTAAGGT-1	Deeper Layer
TCCCGGACATAAACCT-1	Interneurons2
TCAATCGCATCATGTG-1	V-SVZ
TCATAACCATAGCAGG-1	Interneurons1
TCATTGTTCAGCATTA-1	Upper Layer
TCCATCATCATGGTTA-1	RG, Astro, OPC
TCCATATTCATGACCG-1	Upper Layer
TCCGCCATCTCACACC-1	RG, Astro, OPC
TCAGGAGCACCTAAGC-1	V-SVZ
TCATACTTCCCGCAAA-1	Deeper Layer
TCCCTCACAGTACCGT-1	Ependymal cells
TCATGTTTCCTTCAAT-1	Upper Layer
TCAGGTCCAGTATGTT-1	RG, Astro, OPC
TCAGTGAGTAATGGCC-1	RG, Astro, OPC
TCCGCCATCCATTACT-1	V-SVZ
TCCGGTAAGGCGCATC-1	Deeper Layer
TCCATCATCTCACTAT-1	Upper Layer
TCCATATTCAATCTCT-1	Interneurons1
TCAGGTTAGGGTCTAT-1	IPC
TCAATCGCACTTACAG-1	Interneurons3
TCACCTGGTTGGTTCT-1	Upper Layer
TCCAGCAAGGAGGCAT-1	V-SVZ
TCCAGCAAGTTAGGCT-1	RG, Astro, OPC
TCAGGTTAGTGAGAGC-1	RG, Astro, OPC
TCATGTTTCAGGCCTA-1	Interneurons3
TCAGTGAGTTAACGAT-1	Deeper Layer
TCACCTCAGAGCAAGC-1	Upper Layer
TCATGCCTCTCACTAT-1	Upper Layer
TCAGTGAGTGGACCTG-1	RG, Astro, OPC
TCCATTGTCCCTCTAA-1	Upper Layer
TCAGTGAGTGTTTGTC-1	Deeper Layer
TCCACAACAAGGGTTG-1	V-SVZ
TCCCGGACAAATATCC-1	Upper Layer
TCCCGGACATGAAATG-1	RG, Astro, OPC
TCAAGCTAGTATCGCG-1	Upper Layer
TCAGGTCCACCATATG-1	Interneurons1
TCACCTCAGATGGAGC-1	V-SVZ
TCCATAAAGCCAAATC-1	Upper Layer
TCCACAACATGCTTAG-1	Upper Layer
TCATTTGGTGAACAAA-1	Interneurons2
TCACGGATCATAACGC-1	Upper Layer
TCCAGCAAGCATTTCT-1	RG, Astro, OPC
TCAGCAAGTCATTGTC-1	Upper Layer
TCATAACCATCGTTCT-1	Deeper Layer
TCACTGACATTGCGTA-1	Deeper Layer
TCAGTAATCAGCACGC-1	Interneurons2
TCATGTTTCAGAAACG-1	Upper Layer
TCAATCGCATGAATAG-1	Interneurons2
TCATAACCATCCTGAA-1	RG, Astro, OPC
TCCACAACAGTTGCGT-1	Upper Layer
TCAATCGCAAAGCTCC-1	RG, Astro, OPC
TCAGCCTTCGTTAGCG-1	Deeper Layer
TCAGTAGGTGCTTACT-1	Deeper Layer
TCAAGCTAGGACCTCA-1	Ependymal cells
TCCATCATCGCACACA-1	V-SVZ
TCATTACTCGCCTGTT-1	Deeper Layer
TCACGGATCGACCTGA-1	Upper Layer
TCAAGCTAGCACTTGG-1	Deeper Layer
TCCAGGTCAGTACCGT-1	Interneurons1
TCAAGTATCGCAACAT-1	Deeper Layer
TCATGCCTCGGTCATG-1	Upper Layer
TCATTTGGTGAAACAA-1	Upper Layer
TCCGGTAAGGTGTCCA-1	V-SVZ
TCATGCCTCATAGACC-1	V-SVZ
TCATAACCAGGATAAC-1	RG, Astro, OPC
TCACTGACACGAATCC-1	RG, Astro, OPC
TCCGGAATCACTTTAC-1	IPC
TCAGCGATCCTTAGTT-1	Upper Layer
TCATTGTTCATGTCAA-1	Deeper Layer
TCACCTGGTGTTAGCA-1	Upper Layer
TCAGCGATCTCACACC-1	V-SVZ
TCCTTGCAGGGATGCG-1	Interneurons1
TCCTCAATCGACAAAG-1	Upper Layer
TCGCGAGGTTTAAAGC-1	Deeper Layer
TCCTAGTGTTCACTGT-1	V-SVZ
TCGGTTCTCCCGCCTA-1	V-SVZ
TCTACCTCACCTAAGC-1	Upper Layer
TCGCATTGTGTGCAAC-1	Subplate
TCCTTAGTCGATTTAG-1	RG, Astro, OPC
TCGATTAAGGCTCATG-1	Upper Layer
TCCTTGCAGCTTCCCG-1	RG, Astro, OPC
TCGTAATCAGGACCAA-1	V-SVZ
TCCTCACAGCTATTAG-1	Interneurons2
TCGTAATCACATAACT-1	RG, Astro, OPC
TCTACCTCAGGTTAAA-1	RG, Astro, OPC
TCGACAAGTTGAGGTC-1	Interneurons1
TCGACAAGTGACCTGG-1	Deeper Layer
TCGTTAGCAAAGCTAA-1	Deeper Layer
TCGGTTCTCCCTCGCA-1	Upper Layer
TCTACTAGTAACCACA-1	Upper Layer
TCCGGTTTCGTACCGA-1	V-SVZ
TCCTCAATCCTAATAG-1	Upper Layer
TCGGTTCTCGGTTTCC-1	Upper Layer
TCGCTAACACCTGCTC-1	Interneurons1
TCGCCCATCCAGCACA-1	Deeper Layer
TCTAACCGTTGTCATC-1	RG, Astro, OPC
TCTAACCGTTAAGCCA-1	Interneurons2
TCGATTAAGGCGGGTA-1	V-SVZ
TCGGTAAGTTGTCCAT-1	RG, Astro, OPC
TCCTCAATCGCTTCTA-1	Interneurons2
TCGATTAAGCTGAGGG-1	Deeper Layer
TCGTGCTTCGGTCAGC-1	Subplate
TCCTCAATCACTAGGT-1	Interneurons3
TCCTGTTCAGTGAACG-1	V-SVZ
TCGTAATCAAGTTATC-1	Upper Layer
TCGCCCATCCGTCCAT-1	Interneurons1
TCTAAGGGTGTCCAAA-1	Interneurons1
TCCTAGTGTTAGTGAT-1	Upper Layer
TCGTAATCAGGCCATT-1	IPC
TCCTCTAAGTCATGCG-1	V-SVZ
TCCTCACAGGAACCAA-1	Upper Layer
TCTACTAGTGCATCGG-1	RG, Astro, OPC
TCCTCAATCAGTGAAG-1	RG, Astro, OPC
TCGTTTCCACACAATT-1	Upper Layer
TCCTAGTGTTGGATAT-1	Upper Layer
TCGCGAGGTTCATCTA-1	Upper Layer
TCGCGCACATAAGGAC-1	Upper Layer
TCGTTACGTAATCGGC-1	Interneurons2
TCTACCTCAATCCTAG-1	IPC
TCGCATTGTAAATTGC-1	IPC
TCCTTAGTCTTGGATA-1	V-SVZ
TCTACTAGTTACAACG-1	V-SVZ
TCGGTAAGTCACCAAA-1	Interneurons2
TCCTCACAGTTAGCTA-1	Deeper Layer
TCGTCAACAGTTTGGC-1	IPC
TCCTTCAAGGACTAAG-1	RG, Astro, OPC
TCGTTAAAGCCGCAGT-1	Deeper Layer
TCTAACTTCATGCTCC-1	IPC
TCGCCCATCATTAGGC-1	IPC
TCTAGCACATTATGGT-1	Upper Layer
TCGTCAACATGAAGTA-1	Upper Layer
TCCGGTTTCCGCAAAT-1	Upper Layer
TCCTGTTCAACCCTCC-1	RG, Astro, OPC
TCGGTTCTCGATTTGA-1	Ependymal cells
TCCTGGTTCTGCAAAC-1	Deeper Layer
TCCTTTACACCTACGG-1	V-SVZ
TCGGTTTGTGTTGCTT-1	RG, Astro, OPC
TCCTTGCAGCAGCTCA-1	Upper Layer
TCCTTCAAGTAGAGGC-1	RG, Astro, OPC
TCGTAATCAAACCTAT-1	IPC
TCTACCTCAATTAGGA-1	Upper Layer
TCGCCCATCAGTGAAG-1	Interneurons2
TCGGTAAGTGTCCTGC-1	Deeper Layer
TCGCATTGTTTCGCCA-1	Upper Layer
TCGTTAAAGATTCCTT-1	Upper Layer
TCGCGAGGTTTACCGT-1	Deeper Layer
TCCTTGCAGGTCCACA-1	Cajal-Retzius
TCGTTAGCATTAAAGG-1	Deeper Layer
TCTAACCGTAGCTGGT-1	V-SVZ
TCTACCTCACCTGCTC-1	Deeper Layer
TCCTGGTTCTATCGCC-1	Upper Layer
TCCGGTTTCATAACTG-1	Subplate
TCCTCAATCATGTCAA-1	Subplate
TCGATTAAGGACCAGG-1	Upper Layer
TCGTTACGTTGCAATG-1	Interneurons1
TCGCCCATCGATTCTT-1	V-SVZ
TCGACAAGTTACATCC-1	Deeper Layer
TCCTTCAAGTAACGGA-1	RG, Astro, OPC
TCCTGGTTCTATGACA-1	RG, Astro, OPC
TCCTGTTCATTAGGCC-1	Deeper Layer
TCGCTAACACAAAGAC-1	Upper Layer
TCGTGCTTCTTTAAGG-1	V-SVZ
TCTAATCTCTCTAGCC-1	IPC
TCTAACCGTGTTGTGA-1	Subplate
TGACTCCTCAGTATTG-1	IPC
TGAGGGCCAGCCTGCA-1	Ependymal cells
TCTTGTCCACATGCTA-1	Interneurons2
TGACCAAGTCTTTGAC-1	V-SVZ
TCTTAGTTCCGCCTAT-1	Upper Layer
TGACTTAAGTCCTTCA-1	Ependymal cells
TGAAGGATCGAGCAAA-1	IPC
TCTTCAAGTGGTTCCC-1	Deeper Layer
TGAGAACCAGAATGAC-1	V-SVZ
TCTCCTCGTCAGGCAT-1	Upper Layer
TCTAGCCTCTTTGTAC-1	RG, Astro, OPC
TCTTGACGTTAGGACC-1	Interneurons3
TGACTCCTCCGCAACA-1	Deeper Layer
TCTTGTCCAACCGCCA-1	Interneurons2
TGAGCAAAGACACTTA-1	RG, Astro, OPC
TGAGCTTAGAACCTGT-1	IPC
TGAGCAAAGCACAGGG-1	RG, Astro, OPC
TCTTAGTTCGAGGAGT-1	V-SVZ
TCTTTGTAGGCTACAT-1	V-SVZ
TGAAACTGTCAAGTAT-1	V-SVZ
TCTTTGTAGTTATGGC-1	Upper Layer
TGAGGGCCATTTGCTC-1	V-SVZ
TGAACAGAGCAGGTGG-1	Deeper Layer
TGATCACAGATAAAGC-1	Upper Layer
TCTTAGCGTTGAGCCG-1	RG, Astro, OPC
TCTTAGTTCTTGCATT-1	Deeper Layer
TCTTCAAGTTGAGGTC-1	Upper Layer
TGACTTCGTCAAAGGG-1	IPC
TCTCAAGCAAAGCTCC-1	V-SVZ
TGAGTGAAGACTCGCA-1	RG, Astro, OPC
TGATCAATCATTGACA-1	Upper Layer
TGACCTTGTTAAGTGT-1	Deeper Layer
TGACTTCGTAATAACC-1	Interneurons2
TGAGGCACAGGTCCTG-1	Upper Layer
TGATCAATCCTTAGGG-1	Deeper Layer
TCTTAGTTCCTCCTAA-1	Upper Layer
TCTGGCTTCATGGTGT-1	V-SVZ
TCTGTGACAGGCATCT-1	Interneurons1
TGACCTTGTTTGCTGT-1	V-SVZ
TCTGTGACAGGTTACC-1	Upper Layer
TGACCTTGTCCTAACT-1	Deeper Layer
TCTAGCCTCTCTAGCC-1	Cajal-Retzius
TGAAACTGTTCCGGGA-1	Ependymal cells
TCTCAATTCCGGTTAG-1	Upper Layer
TCTAGCGAGGCATGTT-1	RG, Astro, OPC
TGATCACAGCGAGCGA-1	Deeper Layer
TCTTCAAGTAGCTAAT-1	Ependymal cells
TCTTGACGTTGGATCA-1	Deeper Layer
TCTCGCCCAGCCTTGG-1	Deeper Layer
TCTGTGACACTAAATC-1	Deeper Layer
TCTTGTCCATGTCGCG-1	Upper Layer
TGACCAAGTCGCGCAA-1	Deeper Layer
TGACTTCGTACTGAAT-1	Upper Layer
TGACTTCGTGTTTGCT-1	Deeper Layer
TCTTGTCCATGTGGGA-1	Deeper Layer
TCTCAAGCAGGATTAA-1	Upper Layer
TGAGTTTCATGGTTAT-1	RG, Astro, OPC
TCTTAGCGTTCCTGTG-1	Upper Layer
TGAGTTTCATGAATCT-1	Deeper Layer
TGAGGGCCATAATCCG-1	Interneurons3
TGAGCCGGTAGGATTT-1	Deeper Layer
TCTATGTTCCTTGAGG-1	RG, Astro, OPC
TCTATGTTCCCGCAAA-1	Ependymal cells
TGAGCTTAGCTCCTAC-1	Interneurons1
TCTTAGCGTCAAACTG-1	Interneurons1
TCTATGTTCGGCCAGT-1	RG, Astro, OPC
TGAAGTGAGCTTACTT-1	Deeper Layer
TGACTTAAGGCGCACT-1	Cajal-Retzius
TCTCCTCGTAAACAAG-1	RG, Astro, OPC
TCTCCTCGTACCGTTT-1	V-SVZ
TCTAGCGAGCACTAAC-1	V-SVZ
TGAAGTGAGCAAGACA-1	Upper Layer
TGACTTAAGCATGCAT-1	Deeper Layer
TCTTAGCGTGCATCGG-1	V-SVZ
TCTAGCCTCCATTACT-1	Deeper Layer
TGAACAACACCACAAC-1	Subplate
TGAGGGCCAACCCTAA-1	RG, Astro, OPC
TCTTGTCCAGCAAATA-1	Deeper Layer
TGACTCCTCAATCTCT-1	V-SVZ
TGAGTTTCAATGCCCG-1	Interneurons2
TCTCAATTCCCTCAAC-1	Deeper Layer
TGAGGTGCATCCTGAA-1	Upper Layer
TCTCACCAGTCATTAG-1	IPC
TCTGGCTTCACCGGTA-1	Deeper Layer
TCTGTGACAAGGTAAC-1	RG, Astro, OPC
TGAGTTTCAGGAACAT-1	Upper Layer
TGAGCTTAGTCACCTC-1	Interneurons1
TCTCGCCCACTTGTTC-1	Upper Layer
TCTTGTCCATGGAGGC-1	Upper Layer
TGAGGAGGTAGGTTAT-1	Deeper Layer
TGACTTAAGACTATTG-1	Deeper Layer
TGCTGGATCCATAAGC-1	Subplate
TGCATGAGTAATCGGC-1	Deeper Layer
TGCGCAGGTATTACCC-1	RG, Astro, OPC
TGCTATGCATGCTCCC-1	Upper Layer
TGCTCTCAGACAGGTA-1	Deeper Layer
TGATGACTCGCTAGTG-1	IPC
TGCTAGCCAGCAAATA-1	RG, Astro, OPC
TGCTATGCAGCTTAGC-1	Subplate
TGCTCAACATTGCAGC-1	Subplate
TGATCGAGTGTTTGAG-1	V-SVZ
TGATCACAGCTTTGGG-1	Interneurons2
TGCTCTCAGCACTAGT-1	V-SVZ
TGATCAGGTTATTGCC-1	Upper Layer
TGCACCTTCGTTTCGC-1	V-SVZ
TGCACTTGTGGGTACT-1	Upper Layer
TGCTCCGTCTCCTCAA-1	Upper Layer
TGCAGGCTCATGTCAA-1	Upper Layer
TGCGATTAGACAACGA-1	RG, Astro, OPC
TGATGATGTCGCAATA-1	Upper Layer
TGCCATTGTGGATTGC-1	IPC
TGATCACAGTTGGCCA-1	Upper Layer
TGCCATTGTCATCAAG-1	RG, Astro, OPC
TGCTAACAGTTCCCGT-1	Upper Layer
TGATCACAGGCTTAAC-1	Interneurons1
TGCCTGTTCATGGCTG-1	Ependymal cells
TGCAGGCTCCTTGTTG-1	Ependymal cells
TGATTGCAGGAGCATA-1	Deeper Layer
TGCGATTAGTATTGTG-1	Interneurons3
TGCACACCATCATGTG-1	V-SVZ
TGATGATGTAAGCTTG-1	Deeper Layer
TGCACACCAAATGCCC-1	Upper Layer
TGCTCAACAAGCTTTG-1	RG, Astro, OPC
TGCATTAAGTTATCTC-1	Ependymal cells
TGCTAACAGCGAGTAA-1	Deeper Layer
TGCCATTGTTAGTACG-1	RG, Astro, OPC
TGCCATTGTACGTTTC-1	RG, Astro, OPC
TGATCCTGTTGAGGTC-1	IPC
TGCATCCTCAACAAGG-1	RG, Astro, OPC
TGCGGTTCATTGTGCA-1	Interneurons2
TGCTAACAGGCTAAGA-1	Interneurons2
TGCAGGCTCCGGAACC-1	IPC
TGCTCCGTCATGTTTC-1	V-SVZ
TGCGCGAGTGCTAGCG-1	Interneurons1
TGATGATGTCCTAGTT-1	RG, Astro, OPC
TGCGATTAGCTATGAC-1	IPC
TGCTAGCCAACTGGCT-1	IPC
TGCTCAACATAGCGAG-1	IPC
TGCTCACTCCAGCACA-1	RG, Astro, OPC
TGCTAGCCAGTAGGAT-1	Interneurons1
TGATGACTCGAAGCGG-1	V-SVZ
TGATCAGGTGAGCGAA-1	V-SVZ
TGCTCCGTCGCTAAGT-1	Deeper Layer
TGATTGCAGGAATAAC-1	Upper Layer
TGCTCCGTCTCATCAT-1	V-SVZ
TGATGATGTCTATCGT-1	RG, Astro, OPC
TGCTCAACAGCACGTT-1	Upper Layer
TGATGAACAGGAATCG-1	Deeper Layer
TGCATGAGTGGAAGGC-1	V-SVZ
TGCCGGTAGGCTACTG-1	Upper Layer
TGCTAACAGTAATCCA-1	Deeper Layer
TGCTCTCAGCTCAAAC-1	V-SVZ
TGCACCTTCAAATCGC-1	V-SVZ
TGCACTTGTTGTGACA-1	Deeper Layer
TGCCTGTTCCCTGATC-1	Upper Layer
TGCTATGCATCCGTAA-1	RG, Astro, OPC
TGCCTGTTCGGTCATG-1	Upper Layer
TGATCGAGTTTCCACG-1	Deeper Layer
TGCAATATCATGCCTC-1	Interneurons3
TGCTCTCAGCGGATAA-1	Upper Layer
TGCTAGCCACTGACTA-1	Interneurons1
TGCACTTGTTGCACAA-1	Microglia
TGATCGAGTTTATGGG-1	Deeper Layer
TGCAAGCGTATTCGTC-1	Interneurons2
TGCTCAACAAACGGGC-1	Microglia
TGATTCAAGTTATGGC-1	Deeper Layer
TGCTCACTCCTTAATC-1	Deeper Layer
TGATTCAAGTTTGTCT-1	Interneurons3
TGCATTAAGGACCTGC-1	Upper Layer
TGATCACAGCGGATAA-1	Interneurons1
TGCTGGATCTACCTGC-1	Interneurons2
TGATGATGTTACTTCA-1	Upper Layer
TGCGGTTCATGTCAGC-1	Interneurons3
TGATCGAGTGCATTAG-1	Interneurons3
TGCGGTTCAATAGCAA-1	V-SVZ
TGCGATTAGGTCCTGA-1	Upper Layer
TGCAAGCGTTTCCTCC-1	Deeper Layer
TGCTATGCAGTTAAAG-1	V-SVZ
TGCATGAGTCCCGAAG-1	Deeper Layer
TGCATCCTCAATCTCT-1	Deeper Layer
TGGTCATAGGGATTAG-1	IPC
TGCTTGCTCCTCCTAA-1	Interneurons1
TGCTTGCTCGCCTGTT-1	Ependymal cells
TGGATTGGTTCGCTCA-1	IPC
TGGATTCAGTTATGTG-1	Interneurons1
TGGCCATCACAGAAAC-1	RG, Astro, OPC
TGGCCTTTCTCACACC-1	Upper Layer
TGGGCATGTTGCCTCA-1	Upper Layer
TGTAAGTGTCGACTCC-1	Upper Layer
TGCTTTAGTTACAACG-1	Upper Layer
TGTAAAGCAAACTGCC-1	Deeper Layer
TGGCCATCAGGTTATT-1	Deeper Layer
TGTAATGTCCTGGTGA-1	Upper Layer
TGGTCAGTCCGCAACA-1	Interneurons3
TGCTTGCTCCCTCTAA-1	V-SVZ
TGCTTAAAGCTTACTT-1	Deeper Layer
TGGCTATAGGTAGCTT-1	Deeper Layer
TGGCGGTTCCGGTTGA-1	Deeper Layer
TGGTAAACAACCGCCA-1	Interneurons2
TGGGCATGTCAAGTAT-1	V-SVZ
TGGTCAAGTGGACCTG-1	Deeper Layer
TGGCGGTTCCTAATAG-1	IPC
TGGACGGAGGAGTCTT-1	Deeper Layer
TGGCCTTTCCACCTGT-1	Upper Layer
TGGACAAAGTTCCTCA-1	Upper Layer
TGTAAAGCATCTAGCA-1	Upper Layer
TGTAAGCTCAAGCTTA-1	Interneurons2
TGGCCAATCGTCATTT-1	Upper Layer
TGGCGGTTCATCCTGC-1	Interneurons1
TGGCTAAGTCTAACCT-1	RG, Astro, OPC
TGTAAGTGTCTCACTG-1	Upper Layer
TGCTTAAAGCTGTACG-1	Deeper Layer
TGCTTCATCGTTATAG-1	Upper Layer
TGTAAGCTCGGTAACT-1	Upper Layer
TGGGCCTAGTCATTTC-1	V-SVZ
TGGTCATAGTAGCCAT-1	IPC
TGGGCATGTTGGTTCT-1	V-SVZ
TGGTGATTCCCTGGAA-1	Subplate
TGGACTAGTCAATAGT-1	Upper Layer
TGGTCATAGTTAACCA-1	Deeper Layer
TGGTCAAGTGATGAGG-1	Interneurons1
TGGCTTTGTTAGAGCC-1	IPC
TGTAAGCTCTAATCAG-1	Interneurons3
TGGTTCCTCGCACACA-1	V-SVZ
TGGCCATCAAGTCGCT-1	Upper Layer
TGGTCATAGCTTAACA-1	Upper Layer
TGGTTGAGTATTTGGG-1	Upper Layer
TGCTTCATCGGTCAAT-1	Upper Layer
TGGTCCTTCGCATTAA-1	Interneurons1
TGGACTAGTAAGCTCA-1	Interneurons2
TGGTCCTTCATGCTCC-1	Deeper Layer
TGCTTTAGTGCAATAT-1	Interneurons2
TGGCTTTGTCGCAATA-1	Upper Layer
TGGCGGTTCTTGCTAT-1	RG, Astro, OPC
TGGCCTGCACTTACAG-1	Deeper Layer
TGGACCGGTCATTGTC-1	Subplate
TGTAATGTCATGCAAC-1	Deeper Layer
TGCTTGTGTAGCAGCT-1	Interneurons1
TGTAAGCTCCACCTTA-1	Upper Layer
TGGACTAGTGTTGCTT-1	RG, Astro, OPC
TGCTTTAGTAAAGCAA-1	V-SVZ
TGGGCATGTACTGATG-1	RG, Astro, OPC
TGTAACTCAGAAATGC-1	Upper Layer
TGGTTGAGTCCCGGAA-1	Upper Layer
TGGTCAGTCCGGTTAG-1	Deeper Layer
TGGCCATCATAAGTTC-1	Subplate
TGTAATGTCGGTTTGG-1	V-SVZ
TGGCCTTTCCGGTTAG-1	RG, Astro, OPC
TGGCCAATCGCTAAGT-1	Upper Layer
TGCTTCCAGGCGCTAC-1	Microglia
TGGTCATAGAGAGGCT-1	V-SVZ
TGCTTAAAGTAACGAG-1	RG, Astro, OPC
TGCTTGTGTAGCCATA-1	Deeper Layer
TGCTTCATCAGGGCCT-1	Interneurons1
TGGATTGGTTGCAATG-1	Deeper Layer
TGTAAAGCAGCAAGGC-1	Upper Layer
TGGACCGGTTCACCCA-1	Upper Layer
TGGTTGAGTCTATCGT-1	Interneurons2
TGTAAGCTCGCACAAT-1	Upper Layer
TGGGCCTAGCTATTAG-1	RG, Astro, OPC
TGGTCCTTCCACCCTG-1	Upper Layer
TGTAAGCTCTGTTGCC-1	Interneurons1
TGGTCATAGCCTTAAA-1	Deeper Layer
TGGCTTTGTCTCAGCC-1	V-SVZ
TGGTTCTGTCATGCAA-1	Upper Layer
TGGTCCTTCGCTAGAT-1	Upper Layer
TGGTAAACAGCAAATA-1	Upper Layer
TGCTTGCTCCGTGACA-1	Interneurons1
TGGCGGTTCCAACTGG-1	RG, Astro, OPC
TGGTTCTGTTAGAGGG-1	V-SVZ
TGGAACAAGGTAAGCA-1	Deeper Layer
TGGATTGGTCAATGTG-1	Interneurons1
TGGTAAACATCCGTAA-1	Interneurons1
TGTTACTTCTGTAAGC-1	Upper Layer
TGTATCGCACGTAATT-1	Interneurons1
TGTCAATCAGCAAGGC-1	Interneurons1
TGTGGCGGTCTTGCTG-1	Upper Layer
TGTTTGTTCTAAGGTC-1	Upper Layer
TGTTGTTTCAAATCGC-1	Upper Layer
TTAATCGAGTTTGCGG-1	RG, Astro, OPC
TTAACCAAGTTTCCTG-1	Upper Layer
TGTGTTAAGGTCCACA-1	Microglia
TTAAGTGTCCAAATCA-1	V-SVZ
TGTATCCGTGTTTCAC-1	Upper Layer
TGTGCAAGTGAGACTC-1	Interneurons2
TTAGCAGGTTGTAACG-1	Upper Layer
TTAACTGAGCCGCTAA-1	IPC
TGTCAGTAGGAAACTG-1	Upper Layer
TGTGGCTCAGGCTACT-1	Deeper Layer
TTACCTGTCCGGTATG-1	RG, Astro, OPC
TGTGGCTCACTTGTTC-1	Interneurons1
TGTGGCCAGGCTATGT-1	Upper Layer
TGTGTGAGTACTGAAT-1	Upper Layer
TGTGTGAGTTGTGACA-1	Upper Layer
TTAGCAGGTACTGAAT-1	Deeper Layer
TGTTAGCAGTTAGTGC-1	Interneurons2
TTACACCGTCCTCCAA-1	Upper Layer
TGTGCTGAGGAGGGTT-1	Upper Layer
TGTTGTGCATTATCCC-1	V-SVZ
TGTATCGCAAAGCTCC-1	Interneurons1
TTAGCAGGTGCAATAT-1	Deeper Layer
TTAAGGACAAACCTAT-1	Upper Layer
TGTCAGTAGGAGGGTT-1	Upper Layer
TTACACCGTGCTTAGA-1	Deeper Layer
TTAACTGAGTGAGCAA-1	V-SVZ
TGTGGCTCACCGTTCC-1	RG, Astro, OPC
TGTTGGCCAACCCTAA-1	Upper Layer
TTACAGCAGGCGGATG-1	V-SVZ
TGTGGCCAGTTTAACG-1	V-SVZ
TTAAGGTGTCCACAAA-1	Upper Layer
TTACCGTGTAAACAAG-1	Interneurons2
TGTTCATTCGATTTGA-1	Interneurons1
TGTGCGGGTATTTGCC-1	RG, Astro, OPC
TTACCTGTCGCCTAAG-1	Deeper Layer
TTACGTTTCTTAGGGT-1	Subplate
TTAGCGGTCATAGACC-1	V-SVZ
TGTCAGTAGAGAGGAG-1	Interneurons1
TGTCCTGGTTTAACCC-1	Upper Layer
TGTTATGAGTCATTAG-1	Upper Layer
TTAGCCTGTTCCATTA-1	IPC
TGTTCATTCAATGAGG-1	RG, Astro, OPC
TTAACTGAGTCCTGAG-1	V-SVZ
TTAGAAGCACCTACTT-1	RG, Astro, OPC
TTAGACTCACTAAGCC-1	Upper Layer
TGTGCGGGTTTAGTCC-1	Upper Layer
TGTGTGAGTTAGGCTA-1	RG, Astro, OPC
TTAACTGAGTTGCCTC-1	RG, Astro, OPC
TTAGCCTGTTTGGGCG-1	RG, Astro, OPC
TGTGTGAGTGCATTTC-1	Interneurons2
TTAAGTGTCAACAAGG-1	Interneurons1
TGTGTTAAGGCAAGTA-1	Upper Layer
TGTTTGTTCGTTAACA-1	V-SVZ
TTAAGGTGTTGACTTC-1	Deeper Layer
TTAAGTGTCCTAACGG-1	Upper Layer
TGTTCATTCGCTCACT-1	V-SVZ
TGTTGTGCAGGCCATT-1	Deeper Layer
TGTGCACCAATGCGCT-1	Upper Layer
TGTTGCACATTAGGTT-1	Upper Layer
TGTCAGTAGGACCTGC-1	RG, Astro, OPC
TTAATCGAGTAACTCA-1	IPC
TGTGCTGAGCTAATCA-1	Interneurons1
TTAGCAGGTCACTCGC-1	Interneurons3
TGTTGCACATAATGTC-1	Interneurons1
TGTTGCACAATTTGGT-1	RG, Astro, OPC
TTACACCGTTGGTTCT-1	Interneurons2
TGTTTGTTCCAGGGAG-1	Ependymal cells
TTACGTTTCGCATTAA-1	Deeper Layer
TGTCCTGGTGGATTCA-1	V-SVZ
TTACGTTTCGATATTG-1	Upper Layer
TTAATCGAGCTACTGG-1	Interneurons1
TGTGATCAGCTATTGA-1	V-SVZ
TGTCCTTCATGTGGGA-1	Cajal-Retzius
TGTGGAGCAATGCCCG-1	Interneurons1
TTAAGTGTCCTGCGAA-1	Upper Layer
TTACCTGTCTACCTCA-1	RG, Astro, OPC
TGTGCGCAGGCATGAA-1	Upper Layer
TGTGGAGCAGTACCGT-1	Upper Layer
TTAAAGGCATAATTGC-1	V-SVZ
TTAGCAGGTCAAACTG-1	Subplate
TGTTGGCCATTATGAC-1	V-SVZ
TGTATCGCACAAGCCT-1	V-SVZ
TGTTGGCCAGAGGCTA-1	Upper Layer
TGTCATAAGTTGTCCC-1	Interneurons1
TGTTGCACATGTTGTG-1	Interneurons2
TGTGCGCAGGTCCTGA-1	Interneurons1
TTATGACCATAATGTC-1	Interneurons1
TTGCGAGTCAGGCTAT-1	Ependymal cells
TTCCTTCTCTGTAATG-1	V-SVZ
TTGCATTTCTGTAAGC-1	Interneurons2
TTAGTCAAGCGCCTTT-1	RG, Astro, OPC
TTCAGTTTCAATGTGC-1	Interneurons2
TTGACATCATTGGGAG-1	Interneurons1
TTCGTGCTCATCCACC-1	Interneurons1
TTCTTAGGTGGTTCCC-1	Deeper Layer
TTAGCTGCATAGCTTG-1	RG, Astro, OPC
TTATTGCTCTTGAGGT-1	Ependymal cells
TTCGTGCTCGGCCAGT-1	Deeper Layer
TTATCCTAGGAAACTG-1	V-SVZ
TTGCAGCCACCGGCTA-1	Deeper Layer
TTCAGCACAAACGGGC-1	Interneurons1
TTGCAGCCAAACTGTT-1	Upper Layer
TTCCTCAAGACAAAGT-1	Interneurons1
TTGCTCTCACTTGTTC-1	Deeper Layer
TTCGTGCTCTTAGCCC-1	IPC
TTAGCTGCATTGCGAC-1	Upper Layer
TTCGCAACATTGTGTG-1	Upper Layer
TTCAACCGTACAAAGA-1	Subplate
TTAGGCCCATCACAGC-1	Subplate
TTAGGCGTCACTCAAA-1	Deeper Layer
TTGCGTCTCGGGACTC-1	V-SVZ
TTGCTCTCACTATGGC-1	Upper Layer
TTAGGCGTCGTCCTTA-1	Deeper Layer
TTGCATTTCAAATCGC-1	Subplate
TTCGTGCTCATGCGTG-1	Upper Layer
TTGACATCAGCTACGT-1	V-SVZ
TTAGTCAAGTAGCTTA-1	RG, Astro, OPC
TTCCACGGTCATCAAG-1	RG, Astro, OPC
TTCTTAGGTGGTTAGC-1	V-SVZ
TTCAGGTAGTAACGAG-1	Deeper Layer
TTCCTTGAGGACCAGG-1	V-SVZ
TTCAGGTAGCTATTAG-1	V-SVZ
TTGACATCAGGAACAT-1	Ependymal cells
TTATAGCCACCTCAGG-1	Interneurons2
TTGCTCTCAAGGACCA-1	Upper Layer
TTATCCGTCCTAAGTA-1	Deeper Layer
TTGCGAGTCCTCCTAA-1	Deeper Layer
TTCATCCCACCACAAC-1	Interneurons1
TTGACGTAGGTGCGGA-1	RG, Astro, OPC
TTGAGGCGTTAGCCAA-1	Upper Layer
TTGCAATCAATGCCTA-1	V-SVZ
TTGCATTTCACTAATG-1	Interneurons1
TTGACGTAGTGAACAG-1	RG, Astro, OPC
TTCATCCCACTAAGCC-1	V-SVZ
TTGACATCAAATATCC-1	Deeper Layer
TTCAGCACAACTGGGA-1	Upper Layer
TTCCCACAGTCTTGAA-1	Upper Layer
TTCAGGTAGGATAAAC-1	Upper Layer
TTCGCAACAGGATGGC-1	V-SVZ
TTGCTCTCACATGCTA-1	Interneurons1
TTCGTTAGTTATCCTA-1	Subplate
TTGCACACACCAGGTT-1	Upper Layer
TTGACATCATGCATAT-1	Interneurons2
TTCGTTAGTATTTGGG-1	Interneurons1
TTCAGTTTCAATCTAG-1	Upper Layer
TTCCACGGTTGTCCAT-1	V-SVZ
TTCCTTGAGTAATCCA-1	Deeper Layer
TTAGTCAAGGGTGAGT-1	RG, Astro, OPC
TTGACGTAGTGATTCA-1	Upper Layer
TTGACATCACATAACT-1	RG, Astro, OPC
TTATGCGCAGCACGTT-1	Interneurons2
TTATGCGCAAACTGCC-1	Interneurons3
TTAGGCCCATTTAAGC-1	Ependymal cells
TTAGGCGTCCAGGGAG-1	Interneurons1
TTGCACACAAGTAAGC-1	Deeper Layer
TTAGGCCCAACGTGCT-1	Upper Layer
TTATCCTAGGAACGGT-1	RG, Astro, OPC
TTAGGAACACATAACT-1	Interneurons1
TTAGTCAAGCCTAACG-1	Subplate
TTCGGTACAATTGAGA-1	Upper Layer
TTCTTAGGTCATCAAG-1	V-SVZ
TTAGGATGTTTCCGGC-1	Deeper Layer
TTCCCACAGTTTGTCT-1	Deeper Layer
TTGCAAGGTGCGCGTA-1	Interneurons1
TTAGGCTAGGGACTAA-1	Interneurons2
TTATGACCAGTTTCTC-1	Upper Layer
TTCATCCCAGTCTAAT-1	V-SVZ
TTCAGTTTCCATCAGG-1	Deeper Layer
TTGACGTAGGAACGCG-1	Interneurons3
TTGACTAAGCACAGCC-1	V-SVZ
TTCCCGCCATTAAAGG-1	Interneurons3
TTATCCTAGGCGAATA-1	Deeper Layer
TTCATTCAGGAGCACG-1	Deeper Layer
TTGAGCTAGGTCCAAT-1	V-SVZ
TTGAGGCGTTTGAGGC-1	Deeper Layer
TTGAGCTAGAGGAGGA-1	Deeper Layer
TTAGTCAAGCTTGCTC-1	Cajal-Retzius
TTGCATTTCTCAATTC-1	Deeper Layer
TTGCACACAGGACCTT-1	Upper Layer
TTGACTAAGTTAGGCT-1	Interneurons2
TTGGGCCAGCTGTCAG-1	V-SVZ
TTGTGAGGTTCGGGAT-1	RG, Astro, OPC
TTGTGCCTCAATGACC-1	Interneurons3
TTTAACCTCACTAAGC-1	V-SVZ
TTGTCAAAGGTGAGAC-1	Deeper Layer
TTGTGTGCAAGTGTTT-1	Interneurons1
TTGTGAGGTGGATTAT-1	Upper Layer
TTGTCCGGTTGCAATG-1	RG, Astro, OPC
TTGTCCATCTTGTCCA-1	Interneurons1
TTGTCAAAGGAAGTAT-1	Upper Layer
TTGTGTGCAGCACGTT-1	RG, Astro, OPC
TTGGCTTGTTAATGAC-1	IPC
TTGGATTCATTGTCAG-1	Interneurons1
TTTAACCTCCATTACT-1	Deeper Layer
TTGTCCATCGTTATCT-1	Upper Layer
TTGTTGCGTAGGTTTG-1	RG, Astro, OPC
TTTAAGGTCGGCCAGT-1	V-SVZ
TTGCTTAGTACCGGAT-1	Interneurons2
TTGTTGTTCATGCAAC-1	V-SVZ
TTTACGAAGGAGCAAC-1	RG, Astro, OPC
TTGTGTGCAGGGAGGA-1	Upper Layer
TTGGATATCCGTAAAC-1	Deeper Layer
TTTAAGCCACAAAGAC-1	Upper Layer
TTGGGCGGTGTCCAGG-1	V-SVZ
TTGGGCCAGTGAGGGT-1	V-SVZ
TTTAACCTCAGGAACA-1	V-SVZ
TTGTTCCCATAAGTCT-1	RG, Astro, OPC
TTGGATCAGCATCCAG-1	Deeper Layer
TTGGTGAGTGTCCAGG-1	IPC
TTGTTTGGTCAATAGT-1	Upper Layer
TTGGGCCAGTTGGCCA-1	Interneurons1
TTGTGCGAGCACTAAC-1	RG, Astro, OPC
TTGTTGCGTTAGCGTA-1	Upper Layer
TTGGATCAGTTCCCGT-1	V-SVZ
TTTAGCAAGCATTAGC-1	RG, Astro, OPC
TTGTTTGGTAACAGGG-1	Interneurons1
TTTACGAAGCACTAAC-1	Interneurons1
TTGCTCTCAGTAGGAT-1	Deeper Layer
TTGGGCCAGGTGAGAC-1	RG, Astro, OPC
TTGGATCAGTGTGATC-1	Interneurons2
TTGGCTACAGGTATTT-1	V-SVZ
TTGCTTTAGTATTGGC-1	RG, Astro, OPC
TTTAACCTCACGCGGT-1	Cajal-Retzius
TTTACGCGTCCGTAGG-1	V-SVZ
TTGGGTTAGGAACGGT-1	V-SVZ
TTTAAGGTCGGGACCT-1	V-SVZ
TTGGATCAGCGATAAG-1	V-SVZ
TTGTGCCTCCTTAGTT-1	Deeper Layer
TTGTCCATCTTGCATT-1	Interneurons3
TTGTGAGGTGCTCCAC-1	Deeper Layer
TTGTCCATCCTAGTTT-1	V-SVZ
TTTAAGCCAATTATGC-1	Interneurons1
TTGGAGGCAATAACGA-1	Deeper Layer
TTGTCAAAGCACTAGT-1	V-SVZ
TTGGAGGCATGTTTGG-1	RG, Astro, OPC
TTGTGCCTCATGGCTG-1	Deeper Layer
TTGTGTGCAACAGGTG-1	V-SVZ
TTGTTGTTCCTAAGGT-1	V-SVZ
TTTACGAAGCATTTCT-1	Ependymal cells
TTTAAGCCACCCACAG-1	Deeper Layer
TTTAACGAGATAACCC-1	Deeper Layer
TTTAGCAAGCATGACT-1	Deeper Layer
TTGTGAGGTCAAAGGG-1	Subplate
TTGGGTTAGGGCCACT-1	Ependymal cells
TTGTTGCGTCAAAGGG-1	V-SVZ
TTGCTTAGTTGCCTCA-1	Deeper Layer
TTGGGTTAGGCTCATG-1	Upper Layer
TTGCTTAGTTGTGATG-1	Deeper Layer
TTTAACGAGAGAAGGG-1	Subplate
TTGGATTCATTGTGGC-1	Deeper Layer
TTGGAGGCACCAAAGG-1	Ependymal cells
TTGGTGAGTAAACAAG-1	IPC
TTGCTCTCAGCCTGCA-1	Upper Layer
TTGGAGGCATGCATAT-1	Deeper Layer
TTTAACGAGTCACCTC-1	Interneurons2
TTGTCCCAGCAATAGG-1	Ependymal cells
TTGGATTCACAATGTT-1	Upper Layer
TTTAAGCCAAAGGCCA-1	RG, Astro, OPC
TTGGCTGAGGCTTAGT-1	Upper Layer
TTGGCTGAGGCGCTAC-1	Interneurons2
TTGGCTTGTCATCATC-1	RG, Astro, OPC
TTGGGCCAGTCACCTC-1	Deeper Layer
TTGTTGCGTTCGCTTG-1	Deeper Layer
TTTAGCAAGCCTGATG-1	IPC
TTGGGCGGTCCTGATT-1	V-SVZ
TTTAACCTCTAGCTAA-1	Subplate
TTGGATATCATAACTG-1	V-SVZ
TTTCGTCCAGGCAAGC-1	Deeper Layer
TTTCACCCAGAAATTG-1	Ependymal cells
TTTGTCTAGCAAACCT-1	Interneurons2
TTTGAGTCACATAGCC-1	V-SVZ
TTTGCGGAGTAGCTTA-1	Deeper Layer
TTTGCATTCACGCGGT-1	Upper Layer
TTTAGGATCTTTAAGG-1	IPC
TTTCTCACACGTGCTG-1	Upper Layer
TTTAGCTTCTACTAAG-1	RG, Astro, OPC
TTTGTGAAGCTGGAAA-1	Upper Layer
TTTGCATTCCTTGAGG-1	Interneurons2
TTTGAGTCAGTTATGT-1	RG, Astro, OPC
TTTGTTGGTTAGAGCC-1	Upper Layer
TTTCACCCAAGCTACC-1	Interneurons2
TTTGACTTCTCTAGCC-1	Upper Layer
TTTGTCTAGAATCTCA-1	Upper Layer
TTTGTCTAGTTGCCTC-1	Upper Layer
TTTGAGTCAGGTTATT-1	Deeper Layer
TTTGCATTCCGTTAAA-1	Subplate
TTTGTGGCACTCAACA-1	IPC
TTTCCTGAGTAGAGGC-1	Deeper Layer
TTTGTCTAGTCCTTCA-1	Ependymal cells
TTTCTCACAGTAATAG-1	Subplate
TTTGCGACAAGGTAAC-1	Upper Layer
TTTGTCCCATGATTGT-1	Interneurons1
TTTCTCACATAATGAG-1	Upper Layer
TTTGCGGAGCTCCTTA-1	Deeper Layer
TTTGAGTCAGCTTACA-1	Cajal-Retzius
TTTCGTCCAGGACCAA-1	Upper Layer
TTTCTTGCAAGGTCCT-1	Upper Layer
TTTGGTGCACTCAACA-1	Upper Layer
TTTCCTGAGGCGGATG-1	Upper Layer
TTTCTTGCAGTTAGCC-1	Interneurons1
TTTCCGGGTTGTGACA-1	Upper Layer
TTTGCGACATAATCGT-1	Interneurons2
TTTGTCTAGTGAAGTG-1	Upper Layer
TTTATGGAGAACAAGT-1	Upper Layer
TTTCAGTTCAGGAAGC-1	V-SVZ
TTTGGCTGTTACCTGT-1	RG, Astro, OPC
TTTGAGTCATTTGCTC-1	Deeper Layer
TTTGCATTCCTAAGTA-1	Deeper Layer
TTTATGGAGCTGTAAC-1	Interneurons1
TTTGTGAAGGTTAGCT-1	Interneurons3
TTTGTGGCATAATCGT-1	Ependymal cells
TTTGAGTCATAGCAGG-1	Subplate
TTTCCGGGTTGGTTCT-1	V-SVZ
TTTCACCCAGCATGTC-1	Deeper Layer
TTTGTTGGTAGACAAA-1	Interneurons2
TTTCCTGAGGAGCAAC-1	Interneurons3
TTTGCATTCAATGTCA-1	V-SVZ
TTTGTCCCATAATGTC-1	Subplate
TTTGTGAAGTCGCTAG-1	Interneurons1
TTTGTGGCATTTGCTC-1	Upper Layer
TTTCACCCAGAAATGC-1	Ependymal cells
TTTGTCTAGAAAGCAT-1	Subplate
TTTGCGACATAAGTCT-1	IPC
TTTGGTAAGGCGCTAC-1	V-SVZ
TTTGGTGCAATATAGG-1	Upper Layer
TTTAGCTTCAAACCGT-1	Deeper Layer
TTTCAGTTCTACTAAG-1	Interneurons1
TTTGTTGGTGGAGCAA-1	Deeper Layer
TTTATGGAGGGACTAA-1	Upper Layer
TTTCCTGAGGAACCGG-1	V-SVZ
TTTCTTGCAGGCCATT-1	IPC
TTTGGCTGTTAGTTGG-1	V-SVZ
TTTGTGTTCAATGACC-1	IPC
TTTCTTGCACCGGTAT-1	RG, Astro, OPC
TTTGTCTAGCCTGATG-1	Interneurons1
TTTCCGGGTTAATGAC-1	Ependymal cells
TTTATGGAGTGAACCT-1	Interneurons2
TTTCTTGCAGCCTGCA-1	Ependymal cells
TTTGGTAAGCGATACT-1	V-SVZ
TTTGGTAAGTGAGCGG-1	RG, Astro, OPC
TTTGCGGAGGGCCATC-1	Upper Layer
TTTGTCCCAATTTAGC-1	Subplate
